file,report_type,num_input_characters,text_tokens,extr_prompt_instr_tokens,cot_prompt_instr_tokens,total_needed
100150.txt,combined,2342,574,622,801,1997
1004073.txt,combined,1963,461,622,801,1884
1006301.txt,combined,3076,747,622,801,2170
100729.txt,combined,2941,718,622,801,2141
1007502.txt,combined,2251,611,622,801,2034
1009880.txt,combined,2542,611,622,801,2034
1012904.txt,combined,2835,665,622,801,2088
1014012.txt,combined,1639,404,622,801,1827
1016391.txt,combined,1573,376,622,801,1799
1017733.txt,combined,4084,1015,622,801,2438
1019973.txt,combined,7727,1797,622,801,3220
1020709.txt,combined,1657,374,622,801,1797
1021737.txt,combined,7795,2119,622,801,3542
1022364.txt,combined,2817,715,622,801,2138
1024961.txt,combined,2551,649,622,801,2072
1026509.txt,combined,2813,632,622,801,2055
1028731.txt,combined,2811,712,622,801,2135
1029972.txt,combined,1715,401,622,801,1824
103122.txt,combined,2268,567,622,801,1990
1031266.txt,combined,2455,585,622,801,2008
1031743.txt,combined,4617,1457,622,801,2880
1033633.txt,combined,755,203,622,801,1626
1037530.txt,combined,3527,826,622,801,2249
1041684.txt,combined,675,203,622,801,1626
1042445.txt,combined,2607,628,622,801,2051
1044430.txt,combined,411,110,622,801,1533
1044448.txt,combined,2917,726,622,801,2149
1045725.txt,combined,2973,776,622,801,2199
1046098.txt,combined,463,147,622,801,1570
1048022.txt,combined,7048,1754,622,801,3177
1048782.txt,combined,2592,638,622,801,2061
1050579.txt,combined,2702,635,622,801,2058
1050994.txt,combined,3441,938,622,801,2361
1051911.txt,combined,2603,663,622,801,2086
1057509.txt,combined,3204,825,622,801,2248
1058063.txt,combined,1252,273,622,801,1696
1058395.txt,combined,5000,1281,622,801,2704
1060096.txt,combined,2537,599,622,801,2022
1060695.txt,combined,2752,624,622,801,2047
1061513.txt,combined,663,191,622,801,1614
1063104.txt,combined,3157,793,622,801,2216
1063150.txt,combined,3648,864,622,801,2287
1063176.txt,combined,3565,841,622,801,2264
106520.txt,combined,741,208,622,801,1631
1065359.txt,combined,761,188,622,801,1611
1066410.txt,combined,3131,769,622,801,2192
1066995.txt,combined,3327,880,622,801,2303
1068235.txt,combined,2778,661,622,801,2084
1068761.txt,combined,2478,609,622,801,2032
1069515.txt,combined,2179,542,622,801,1965
1070247.txt,combined,2084,513,622,801,1936
1072739.txt,combined,2370,535,622,801,1958
1074265.txt,combined,4887,1096,622,801,2519
1075533.txt,combined,3532,801,622,801,2224
1076826.txt,combined,2583,630,622,801,2053
1076986.txt,combined,2569,625,622,801,2048
1077071.txt,combined,2365,535,622,801,1958
1077516.txt,combined,3301,799,622,801,2222
1078008.txt,combined,2670,675,622,801,2098
1078774.txt,combined,4808,1224,622,801,2647
1080401.txt,combined,2653,614,622,801,2037
1080438.txt,combined,2302,526,622,801,1949
1081091.txt,combined,3391,806,622,801,2229
1082505.txt,combined,2071,481,622,801,1904
1082999.txt,combined,7249,1946,622,801,3369
1083411.txt,combined,2674,623,622,801,2046
1083442.txt,combined,4366,1111,622,801,2534
1085010.txt,combined,3105,779,622,801,2202
1085691.txt,combined,2842,665,622,801,2088
108747.txt,combined,1698,380,622,801,1803
1089362.txt,combined,2550,578,622,801,2001
1089523.txt,combined,7347,1911,622,801,3334
108958.txt,combined,3186,790,622,801,2213
1090241.txt,combined,2326,599,622,801,2022
1092052.txt,combined,3472,825,622,801,2248
109260.txt,combined,2636,620,622,801,2043
1092994.txt,combined,2732,630,622,801,2053
1093699.txt,combined,1845,457,622,801,1880
1093969.txt,combined,4260,1068,622,801,2491
1095907.txt,combined,2906,749,622,801,2172
1096098.txt,combined,3563,810,622,801,2233
1098029.txt,combined,2292,582,622,801,2005
1098748.txt,combined,1725,436,622,801,1859
1100399.txt,combined,4120,996,622,801,2419
110054.txt,combined,5655,1448,622,801,2871
1100595.txt,combined,3085,774,622,801,2197
1102119.txt,combined,3430,767,622,801,2190
1104512.txt,combined,467,125,622,801,1548
1105247.txt,combined,4201,946,622,801,2369
1106419.txt,combined,4364,971,622,801,2394
1106938.txt,combined,5132,1262,622,801,2685
1107810.txt,combined,1628,369,622,801,1792
1107828.txt,combined,2601,621,622,801,2044
1108013.txt,combined,2705,569,622,801,1992
1108098.txt,combined,3016,706,622,801,2129
1108787.txt,combined,2893,675,622,801,2098
1109025.txt,combined,3706,915,622,801,2338
1109080.txt,combined,3374,822,622,801,2245
1109413.txt,combined,2435,630,622,801,2053
1110577.txt,combined,1143,340,622,801,1763
1110794.txt,combined,4212,1140,622,801,2563
1113863.txt,combined,3081,769,622,801,2192
1114924.txt,combined,2708,663,622,801,2086
1115749.txt,combined,4391,1085,622,801,2508
1117087.txt,combined,1881,497,622,801,1920
111738.txt,combined,2136,489,622,801,1912
1118019.txt,combined,2043,486,622,801,1909
1118257.txt,combined,2022,453,622,801,1876
1119161.txt,combined,2674,651,622,801,2074
1120697.txt,combined,3549,874,622,801,2297
1120796.txt,combined,4521,1121,622,801,2544
1120835.txt,combined,3607,968,622,801,2391
1121050.txt,combined,3902,941,622,801,2364
1122244.txt,combined,1908,466,622,801,1889
1122727.txt,combined,3815,938,622,801,2361
112340.txt,combined,4766,1196,622,801,2619
1125637.txt,combined,4665,1348,622,801,2771
1126450.txt,combined,3075,755,622,801,2178
1127404.txt,combined,4573,1163,622,801,2586
1127947.txt,combined,7290,1862,622,801,3285
1128418.txt,combined,3355,816,622,801,2239
113004.txt,combined,780,238,622,801,1661
1130120.txt,combined,8931,2373,622,801,3796
1130580.txt,combined,2982,768,622,801,2191
1131291.txt,combined,3309,824,622,801,2247
1131412.txt,combined,2382,587,622,801,2010
1132082.txt,combined,5655,1348,622,801,2771
1132653.txt,combined,2813,699,622,801,2122
1133061.txt,combined,2855,661,622,801,2084
1133805.txt,combined,3384,914,622,801,2337
1135076.txt,combined,802,219,622,801,1642
1135804.txt,combined,3903,977,622,801,2400
1136997.txt,combined,3790,1014,622,801,2437
1137628.txt,combined,1698,386,622,801,1809
1138298.txt,combined,2884,695,622,801,2118
1140774.txt,combined,4938,1204,622,801,2627
1142224.txt,combined,2176,555,622,801,1978
1142707.txt,combined,3420,846,622,801,2269
1143295.txt,combined,2689,638,622,801,2061
1144356.txt,combined,2040,500,622,801,1923
1145024.txt,combined,3278,777,622,801,2200
1145281.txt,combined,2673,677,622,801,2100
1146143.txt,combined,1859,516,622,801,1939
1146888.txt,combined,4171,1025,622,801,2448
1147283.txt,combined,2786,676,622,801,2099
1147322.txt,combined,7550,2143,622,801,3566
1149446.txt,combined,4434,1251,622,801,2674
1149638.txt,combined,3153,813,622,801,2236
1150440.txt,combined,2358,575,622,801,1998
1153778.txt,combined,2308,576,622,801,1999
1155412.txt,combined,3170,833,622,801,2256
1156267.txt,combined,2248,558,622,801,1981
1156440.txt,combined,4086,1059,622,801,2482
1157207.txt,combined,3286,808,622,801,2231
1158727.txt,combined,847,188,622,801,1611
1160623.txt,combined,480,159,622,801,1582
1161166.txt,combined,3429,853,622,801,2276
1161635.txt,combined,3484,886,622,801,2309
1162274.txt,combined,3364,802,622,801,2225
1163398.txt,combined,1794,438,622,801,1861
1164033.txt,combined,5674,1296,622,801,2719
1164049.txt,combined,1867,446,622,801,1869
1164060.txt,combined,4701,1191,622,801,2614
1164759.txt,combined,2558,692,622,801,2115
1165489.txt,combined,779,191,622,801,1614
1167024.txt,combined,3199,776,622,801,2199
1169327.txt,combined,2439,586,622,801,2009
1171744.txt,combined,3134,736,622,801,2159
1172619.txt,combined,5064,1241,622,801,2664
1173780.txt,combined,2289,577,622,801,2000
1174467.txt,combined,2616,646,622,801,2069
1175297.txt,combined,3267,835,622,801,2258
1176853.txt,combined,4013,964,622,801,2387
1177082.txt,combined,2008,518,622,801,1941
1177122.txt,combined,2641,687,622,801,2110
1177148.txt,combined,586,192,622,801,1615
1177351.txt,combined,2595,645,622,801,2068
1177630.txt,combined,636,148,622,801,1571
1178706.txt,combined,1889,454,622,801,1877
1178863.txt,combined,3658,981,622,801,2404
1181132.txt,combined,3162,845,622,801,2268
1181388.txt,combined,3744,985,622,801,2408
1181436.txt,combined,3041,730,622,801,2153
1183186.txt,combined,598,194,622,801,1617
1184300.txt,combined,783,195,622,801,1618
1185576.txt,combined,2699,695,622,801,2118
1186824.txt,combined,946,268,622,801,1691
1186884.txt,combined,5695,1561,622,801,2984
1188128.txt,combined,3083,891,622,801,2314
1189148.txt,combined,5620,1320,622,801,2743
1189263.txt,combined,3560,854,622,801,2277
1190812.txt,combined,862,261,622,801,1684
1192207.txt,combined,4542,1190,622,801,2613
1194749.txt,combined,3947,999,622,801,2422
1197023.txt,combined,5366,1348,622,801,2771
1199165.txt,combined,1122,250,622,801,1673
120069.txt,combined,3747,847,622,801,2270
1203807.txt,combined,2574,623,622,801,2046
1204131.txt,combined,5967,1549,622,801,2972
1205641.txt,combined,2652,685,622,801,2108
1205840.txt,combined,3418,824,622,801,2247
1208233.txt,combined,2854,712,622,801,2135
1208740.txt,combined,5026,1395,622,801,2818
1209421.txt,combined,2867,707,622,801,2130
1211203.txt,combined,3413,940,622,801,2363
1211282.txt,combined,805,208,622,801,1631
1211374.txt,combined,411,111,622,801,1534
1212081.txt,combined,2293,572,622,801,1995
1213422.txt,combined,2335,569,622,801,1992
1213444.txt,combined,2207,530,622,801,1953
12144.txt,combined,3275,765,622,801,2188
1214634.txt,combined,4494,1151,622,801,2574
1215113.txt,combined,4884,1422,622,801,2845
1215254.txt,combined,1679,394,622,801,1817
1218398.txt,combined,3205,771,622,801,2194
1219243.txt,combined,4578,1118,622,801,2541
1221482.txt,combined,3452,860,622,801,2283
1222698.txt,combined,3474,838,622,801,2261
1223322.txt,combined,2223,587,622,801,2010
1223664.txt,combined,2380,619,622,801,2042
1224467.txt,combined,556,191,622,801,1614
1226239.txt,combined,2373,542,622,801,1965
1226244.txt,combined,3474,909,622,801,2332
1227068.txt,combined,3685,857,622,801,2280
1229304.txt,combined,2722,648,622,801,2071
1229797.txt,combined,1777,453,622,801,1876
1230627.txt,combined,4064,1041,622,801,2464
1231206.txt,combined,2801,681,622,801,2104
1232897.txt,combined,1664,509,622,801,1932
1233017.txt,combined,2968,667,622,801,2090
123483.txt,combined,471,148,622,801,1571
1236616.txt,combined,1810,468,622,801,1891
1237068.txt,combined,3000,744,622,801,2167
1237434.txt,combined,3016,692,622,801,2115
1237652.txt,combined,3324,848,622,801,2271
1237981.txt,combined,3617,867,622,801,2290
1237993.txt,combined,1974,495,622,801,1918
1239735.txt,combined,2444,571,622,801,1994
1240634.txt,combined,2861,703,622,801,2126
1243118.txt,combined,2245,509,622,801,1932
1243481.txt,combined,2914,746,622,801,2169
1244332.txt,combined,3216,788,622,801,2211
1244601.txt,combined,2855,718,622,801,2141
1246295.txt,combined,2609,639,622,801,2062
1246520.txt,combined,3445,850,622,801,2273
1247386.txt,combined,2969,716,622,801,2139
1247526.txt,combined,3123,742,622,801,2165
1247694.txt,combined,4190,1020,622,801,2443
1249167.txt,combined,3285,716,622,801,2139
125021.txt,combined,3901,967,622,801,2390
1252653.txt,combined,1063,268,622,801,1691
1254031.txt,combined,4189,1038,622,801,2461
1254308.txt,combined,2469,616,622,801,2039
1254757.txt,combined,5219,1394,622,801,2817
1257269.txt,combined,2593,607,622,801,2030
1259610.txt,combined,2726,653,622,801,2076
1259672.txt,combined,3346,834,622,801,2257
1260134.txt,combined,3370,835,622,801,2258
1261144.txt,combined,3198,820,622,801,2243
1261266.txt,combined,2676,726,622,801,2149
1262059.txt,combined,2960,762,622,801,2185
1262214.txt,combined,2107,504,622,801,1927
1263722.txt,combined,2611,621,622,801,2044
1264572.txt,combined,3311,789,622,801,2212
1264635.txt,combined,2546,630,622,801,2053
126518.txt,combined,2787,748,622,801,2171
1266668.txt,combined,1901,430,622,801,1853
1266899.txt,combined,2777,688,622,801,2111
1266939.txt,combined,1618,411,622,801,1834
1266956.txt,combined,2773,645,622,801,2068
1269016.txt,combined,1367,336,622,801,1759
1269592.txt,combined,5033,1317,622,801,2740
1271901.txt,combined,3407,832,622,801,2255
1273369.txt,combined,1725,402,622,801,1825
1274025.txt,combined,3149,744,622,801,2167
1274985.txt,combined,2861,752,622,801,2175
1275731.txt,combined,1987,470,622,801,1893
1277035.txt,combined,3043,794,622,801,2217
1277636.txt,combined,816,232,622,801,1655
1279649.txt,combined,4843,1249,622,801,2672
1281645.txt,combined,2980,768,622,801,2191
1284179.txt,combined,2689,654,622,801,2077
1285492.txt,combined,3826,1052,622,801,2475
1287020.txt,combined,1608,387,622,801,1810
1287301.txt,combined,2256,573,622,801,1996
1289220.txt,combined,3921,934,622,801,2357
1289606.txt,combined,1463,371,622,801,1794
1289908.txt,combined,2845,719,622,801,2142
1290087.txt,combined,3307,891,622,801,2314
1290109.txt,combined,2820,716,622,801,2139
1291053.txt,combined,1685,390,622,801,1813
1291361.txt,combined,2281,528,622,801,1951
1291388.txt,combined,1890,471,622,801,1894
1292894.txt,combined,5087,1292,622,801,2715
1293535.txt,combined,1691,421,622,801,1844
1294458.txt,combined,4198,1090,622,801,2513
1294809.txt,combined,1278,319,622,801,1742
1295003.txt,combined,2917,727,622,801,2150
1295666.txt,combined,2724,664,622,801,2087
1295667.txt,combined,2608,633,622,801,2056
1296140.txt,combined,3923,1036,622,801,2459
1296627.txt,combined,1506,376,622,801,1799
1296972.txt,combined,3386,867,622,801,2290
129701.txt,combined,3080,799,622,801,2222
1297318.txt,combined,1472,362,622,801,1785
1298270.txt,combined,1609,407,622,801,1830
1299439.txt,combined,3021,727,622,801,2150
1300290.txt,combined,3132,758,622,801,2181
1302380.txt,combined,10147,2827,622,801,4250
1302562.txt,combined,2406,540,622,801,1963
1303763.txt,combined,1989,550,622,801,1973
1306232.txt,combined,782,211,622,801,1634
1307534.txt,combined,2034,515,622,801,1938
1308813.txt,combined,2980,745,622,801,2168
1309309.txt,combined,3916,1068,622,801,2491
1310803.txt,combined,1409,349,622,801,1772
1311615.txt,combined,4671,1116,622,801,2539
1311697.txt,combined,2637,652,622,801,2075
1312475.txt,combined,3801,896,622,801,2319
1314678.txt,combined,823,242,622,801,1665
1314856.txt,combined,3633,837,622,801,2260
1315408.txt,combined,2600,620,622,801,2043
1316912.txt,combined,1745,438,622,801,1861
1317057.txt,combined,2056,523,622,801,1946
1319384.txt,combined,1183,286,622,801,1709
1319850.txt,combined,1435,367,622,801,1790
1322650.txt,combined,2364,559,622,801,1982
1322881.txt,combined,727,197,622,801,1620
1323861.txt,combined,2334,571,622,801,1994
1324719.txt,combined,1364,353,622,801,1776
1328286.txt,combined,5659,1610,622,801,3033
1328441.txt,combined,6510,1685,622,801,3108
1329878.txt,combined,2530,602,622,801,2025
1330775.txt,combined,2102,495,622,801,1918
1331038.txt,combined,1581,390,622,801,1813
1331317.txt,combined,5598,1291,622,801,2714
1332528.txt,combined,2359,636,622,801,2059
1332542.txt,combined,4334,1130,622,801,2553
1333587.txt,combined,527,130,622,801,1553
1334220.txt,combined,2316,582,622,801,2005
1336513.txt,combined,3571,931,622,801,2354
1336918.txt,combined,2700,696,622,801,2119
1337276.txt,combined,1999,507,622,801,1930
1338180.txt,combined,1859,475,622,801,1898
1338382.txt,combined,607,147,622,801,1570
1340671.txt,combined,1351,347,622,801,1770
1342311.txt,combined,1441,385,622,801,1808
13428.txt,combined,2805,658,622,801,2081
1343542.txt,combined,1234,316,622,801,1739
134424.txt,combined,4018,1060,622,801,2483
1346920.txt,combined,2475,628,622,801,2051
1347145.txt,combined,4077,1016,622,801,2439
1347153.txt,combined,606,159,622,801,1582
1348408.txt,combined,4599,1191,622,801,2614
1348463.txt,combined,3267,793,622,801,2216
1349074.txt,combined,3417,894,622,801,2317
1352387.txt,combined,2857,682,622,801,2105
1354697.txt,combined,1833,435,622,801,1858
1354965.txt,combined,2050,532,622,801,1955
135560.txt,combined,3163,841,622,801,2264
1358956.txt,combined,714,186,622,801,1609
136038.txt,combined,4611,1138,622,801,2561
1361136.txt,combined,1609,427,622,801,1850
1362878.txt,combined,6551,1737,622,801,3160
1362929.txt,combined,4181,981,622,801,2404
136458.txt,combined,7290,2048,622,801,3471
1364626.txt,combined,3402,853,622,801,2276
1365382.txt,combined,1639,411,622,801,1834
1365459.txt,combined,5281,1376,622,801,2799
1366321.txt,combined,3192,822,622,801,2245
1370838.txt,combined,2752,706,622,801,2129
1370858.txt,combined,1307,316,622,801,1739
137217.txt,combined,535,141,622,801,1564
1374085.txt,combined,1655,407,622,801,1830
1374231.txt,combined,599,156,622,801,1579
1374538.txt,combined,2664,646,622,801,2069
1378340.txt,combined,2985,744,622,801,2167
1378907.txt,combined,1134,322,622,801,1745
138405.txt,combined,1479,359,622,801,1782
1384219.txt,combined,2114,516,622,801,1939
138482.txt,combined,2800,744,622,801,2167
1384866.txt,combined,3884,959,622,801,2382
1385239.txt,combined,527,136,622,801,1559
1387465.txt,combined,2419,625,622,801,2048
1393583.txt,combined,4171,1114,622,801,2537
1395126.txt,combined,535,152,622,801,1575
1399385.txt,combined,1332,328,622,801,1751
1399434.txt,combined,557,150,622,801,1573
1399697.txt,combined,2552,648,622,801,2071
1400559.txt,combined,804,227,622,801,1650
1401958.txt,combined,2123,545,622,801,1968
1402243.txt,combined,3150,764,622,801,2187
1406086.txt,combined,3635,971,622,801,2394
1406291.txt,combined,2701,639,622,801,2062
1406690.txt,combined,563,151,622,801,1574
1406838.txt,combined,2502,666,622,801,2089
1410950.txt,combined,2912,767,622,801,2190
1411132.txt,combined,3929,999,622,801,2422
141143.txt,combined,939,243,622,801,1666
1413925.txt,combined,6652,1720,622,801,3143
1414617.txt,combined,1886,481,622,801,1904
1414906.txt,combined,697,199,622,801,1622
1416427.txt,combined,4202,1106,622,801,2529
1416988.txt,combined,2004,535,622,801,1958
1421457.txt,combined,4619,1091,622,801,2514
1421695.txt,combined,1822,471,622,801,1894
1421704.txt,combined,1260,303,622,801,1726
1424032.txt,combined,2011,497,622,801,1920
1424073.txt,combined,2597,627,622,801,2050
1424359.txt,combined,1158,285,622,801,1708
1426731.txt,combined,2355,564,622,801,1987
1427932.txt,combined,1377,381,622,801,1804
1429383.txt,combined,1379,321,622,801,1744
1430225.txt,combined,757,206,622,801,1629
1431251.txt,combined,552,144,622,801,1567
1433822.txt,combined,502,138,622,801,1561
1434930.txt,combined,1241,313,622,801,1736
1435525.txt,combined,838,243,622,801,1666
1435529.txt,combined,2574,683,622,801,2106
1436630.txt,combined,759,243,622,801,1666
1437043.txt,combined,2185,542,622,801,1965
1437599.txt,combined,557,156,622,801,1579
1442020.txt,combined,1309,351,622,801,1774
1442355.txt,combined,2268,568,622,801,1991
1442530.txt,combined,1336,325,622,801,1748
1442833.txt,combined,3252,865,622,801,2288
144296.txt,combined,1670,411,622,801,1834
1444811.txt,combined,2582,642,622,801,2065
1445040.txt,combined,714,175,622,801,1598
1445052.txt,combined,2300,553,622,801,1976
1445467.txt,combined,2441,643,622,801,2066
1445486.txt,combined,2667,754,622,801,2177
1447975.txt,combined,5174,1258,622,801,2681
1448364.txt,combined,2042,513,622,801,1936
1448793.txt,combined,6611,1768,622,801,3191
1451513.txt,combined,2283,547,622,801,1970
1452487.txt,combined,2149,567,622,801,1990
1453377.txt,combined,3085,818,622,801,2241
1453403.txt,combined,2598,635,622,801,2058
1454672.txt,combined,2583,664,622,801,2087
1456142.txt,combined,2693,675,622,801,2098
1456720.txt,combined,1685,438,622,801,1861
1457682.txt,combined,5368,1461,622,801,2884
1457897.txt,combined,2796,699,622,801,2122
1457934.txt,combined,2589,698,622,801,2121
1458541.txt,combined,2483,619,622,801,2042
1460055.txt,combined,1792,470,622,801,1893
1460110.txt,combined,2530,620,622,801,2043
1462301.txt,combined,1681,441,622,801,1864
1462472.txt,combined,1751,484,622,801,1907
1465563.txt,combined,3613,951,622,801,2374
1466419.txt,combined,2244,586,622,801,2009
1468262.txt,combined,1924,531,622,801,1954
1469478.txt,combined,3590,921,622,801,2344
1470637.txt,combined,3897,983,622,801,2406
1472524.txt,combined,3599,990,622,801,2413
1473020.txt,combined,2544,638,622,801,2061
1475415.txt,combined,2040,532,622,801,1955
1475978.txt,combined,1708,455,622,801,1878
1476181.txt,combined,1885,454,622,801,1877
1477536.txt,combined,3071,714,622,801,2137
147889.txt,combined,2527,647,622,801,2070
1486934.txt,combined,2597,651,622,801,2074
1489662.txt,combined,2659,663,622,801,2086
1489909.txt,combined,3401,865,622,801,2288
1496490.txt,combined,1537,359,622,801,1782
1501156.txt,combined,2595,703,622,801,2126
1501323.txt,combined,1591,400,622,801,1823
1501803.txt,combined,1905,463,622,801,1886
1503544.txt,combined,7054,1946,622,801,3369
1503846.txt,combined,3317,906,622,801,2329
1504578.txt,combined,2337,634,622,801,2057
1505227.txt,combined,2912,729,622,801,2152
150951.txt,combined,1242,298,622,801,1721
1510013.txt,combined,3793,941,622,801,2364
1510016.txt,combined,580,145,622,801,1568
1510079.txt,combined,1511,380,622,801,1803
1513259.txt,combined,2057,548,622,801,1971
1513334.txt,combined,2784,676,622,801,2099
1514079.txt,combined,3103,758,622,801,2181
1514775.txt,combined,3595,916,622,801,2339
1517636.txt,combined,532,136,622,801,1559
1518987.txt,combined,1578,389,622,801,1812
1519382.txt,combined,3322,866,622,801,2289
152023.txt,combined,828,232,622,801,1655
152270.txt,combined,549,140,622,801,1563
1524429.txt,combined,3261,862,622,801,2285
1525413.txt,combined,2537,639,622,801,2062
1528517.txt,combined,813,278,622,801,1701
1529931.txt,combined,2587,637,622,801,2060
1535811.txt,combined,3526,838,622,801,2261
1538245.txt,combined,2056,519,622,801,1942
1539606.txt,combined,1704,442,622,801,1865
154306.txt,combined,488,125,622,801,1548
1545677.txt,combined,2995,798,622,801,2221
1546177.txt,combined,762,242,622,801,1665
1547573.txt,combined,4853,1303,622,801,2726
1548478.txt,combined,2222,556,622,801,1979
1548859.txt,combined,3175,856,622,801,2279
1548911.txt,combined,4969,1248,622,801,2671
1549397.txt,combined,3778,1018,622,801,2441
1555261.txt,combined,2006,536,622,801,1959
1560589.txt,combined,4362,1127,622,801,2550
156086.txt,combined,2707,648,622,801,2071
1562677.txt,combined,3133,746,622,801,2169
1565302.txt,combined,3848,1010,622,801,2433
1568369.txt,combined,1870,467,622,801,1890
1568879.txt,combined,948,219,622,801,1642
1569326.txt,combined,2351,574,622,801,1997
1570419.txt,combined,622,175,622,801,1598
157156.txt,combined,5156,1435,622,801,2858
1574092.txt,combined,4423,1089,622,801,2512
1576809.txt,combined,969,248,622,801,1671
1579197.txt,combined,2049,506,622,801,1929
1586663.txt,combined,2454,645,622,801,2068
1586860.txt,combined,2201,596,622,801,2019
1587596.txt,combined,4371,1199,622,801,2622
1591388.txt,combined,1426,369,622,801,1792
1591620.txt,combined,2840,726,622,801,2149
1593669.txt,combined,3469,912,622,801,2335
1597827.txt,combined,1938,480,622,801,1903
1598456.txt,combined,1897,454,622,801,1877
160444.txt,combined,2073,514,622,801,1937
1607304.txt,combined,1592,389,622,801,1812
1610461.txt,combined,1205,296,622,801,1719
1611082.txt,combined,2009,533,622,801,1956
1611667.txt,combined,3991,1349,622,801,2772
1618327.txt,combined,1378,354,622,801,1777
1621194.txt,combined,4117,1078,622,801,2501
1622580.txt,combined,1358,338,622,801,1761
1623163.txt,combined,7195,1970,622,801,3393
1626006.txt,combined,2141,546,622,801,1969
1626507.txt,combined,1916,440,622,801,1863
1629212.txt,combined,2035,506,622,801,1929
1629338.txt,combined,1722,449,622,801,1872
1631415.txt,combined,603,145,622,801,1568
1633435.txt,combined,1629,405,622,801,1828
1641810.txt,combined,6313,1675,622,801,3098
1646430.txt,combined,1089,252,622,801,1675
1649177.txt,combined,431,117,622,801,1540
1650881.txt,combined,622,167,622,801,1590
165361.txt,combined,5133,1406,622,801,2829
1667104.txt,combined,758,223,622,801,1646
166906.txt,combined,3468,879,622,801,2302
1673510.txt,combined,799,217,622,801,1640
168146.txt,combined,590,158,622,801,1581
1700089.txt,combined,744,188,622,801,1611
170012.txt,combined,3566,908,622,801,2331
174746.txt,combined,2754,679,622,801,2102
175401.txt,combined,783,232,622,801,1655
179936.txt,combined,7722,2064,622,801,3487
183957.txt,combined,3136,802,622,801,2225
187518.txt,combined,5798,1422,622,801,2845
188433.txt,combined,3651,898,622,801,2321
194033.txt,combined,2275,597,622,801,2020
206783.txt,combined,595,183,622,801,1606
207046.txt,combined,798,242,622,801,1665
210505.txt,combined,2276,603,622,801,2026
220399.txt,combined,2462,627,622,801,2050
223514.txt,combined,2606,667,622,801,2090
227464.txt,combined,3339,819,622,801,2242
235316.txt,combined,1928,459,622,801,1882
235538.txt,combined,3612,806,622,801,2229
236853.txt,combined,4083,1045,622,801,2468
242635.txt,combined,2142,533,622,801,1956
242907.txt,combined,2163,534,622,801,1957
244078.txt,combined,2418,625,622,801,2048
24410.txt,combined,3269,861,622,801,2284
244688.txt,combined,1710,393,622,801,1816
244874.txt,combined,1022,270,622,801,1693
245815.txt,combined,5172,1370,622,801,2793
245845.txt,combined,3309,886,622,801,2309
249456.txt,combined,1873,516,622,801,1939
250322.txt,combined,2241,552,622,801,1975
252296.txt,combined,540,153,622,801,1576
256537.txt,combined,783,237,622,801,1660
258141.txt,combined,1019,268,622,801,1691
267658.txt,combined,2881,725,622,801,2148
276261.txt,combined,12265,3382,622,801,4805
276343.txt,combined,3445,894,622,801,2317
277917.txt,combined,5052,1291,622,801,2714
279242.txt,combined,2387,577,622,801,2000
284231.txt,combined,3595,825,622,801,2248
286563.txt,combined,3127,736,622,801,2159
288336.txt,combined,2959,732,622,801,2155
291263.txt,combined,2635,574,622,801,1997
292261.txt,combined,2701,688,622,801,2111
294180.txt,combined,3993,966,622,801,2389
296213.txt,combined,771,206,622,801,1629
296602.txt,combined,4868,1261,622,801,2684
30022.txt,combined,552,192,622,801,1615
300560.txt,combined,698,172,622,801,1595
306972.txt,combined,726,221,622,801,1644
307204.txt,combined,4018,1006,622,801,2429
307557.txt,combined,3229,846,622,801,2269
307869.txt,combined,3679,948,622,801,2371
309014.txt,combined,2493,587,622,801,2010
310511.txt,combined,2951,732,622,801,2155
313323.txt,combined,823,216,622,801,1639
313421.txt,combined,3157,830,622,801,2253
315566.txt,combined,1864,471,622,801,1894
319885.txt,combined,2152,571,622,801,1994
322896.txt,combined,2869,698,622,801,2121
323112.txt,combined,1577,368,622,801,1791
324434.txt,combined,3636,969,622,801,2392
330399.txt,combined,3384,812,622,801,2235
330928.txt,combined,2779,639,622,801,2062
331375.txt,combined,2771,686,622,801,2109
333937.txt,combined,1895,467,622,801,1890
334421.txt,combined,4124,1078,622,801,2501
335339.txt,combined,765,217,622,801,1640
336310.txt,combined,3648,833,622,801,2256
343698.txt,combined,3054,742,622,801,2165
345463.txt,combined,2725,617,622,801,2040
345750.txt,combined,4290,1069,622,801,2492
347246.txt,combined,1949,488,622,801,1911
348061.txt,combined,3302,798,622,801,2221
357871.txt,combined,3009,801,622,801,2224
359824.txt,combined,3321,923,622,801,2346
359825.txt,combined,925,199,622,801,1622
361167.txt,combined,3314,854,622,801,2277
36311.txt,combined,2891,755,622,801,2178
364959.txt,combined,750,234,622,801,1657
367722.txt,combined,1692,424,622,801,1847
368373.txt,combined,3274,837,622,801,2260
375374.txt,combined,470,124,622,801,1547
376941.txt,combined,4116,1101,622,801,2524
378985.txt,combined,897,233,622,801,1656
381326.txt,combined,2951,706,622,801,2129
381460.txt,combined,2973,765,622,801,2188
385207.txt,combined,6681,1868,622,801,3291
386754.txt,combined,1931,495,622,801,1918
388285.txt,combined,787,212,622,801,1635
388442.txt,combined,3419,857,622,801,2280
392130.txt,combined,2543,602,622,801,2025
395523.txt,combined,1366,323,622,801,1746
398501.txt,combined,2881,761,622,801,2184
401228.txt,combined,1517,447,622,801,1870
410264.txt,combined,1650,421,622,801,1844
414957.txt,combined,540,134,622,801,1557
41566.txt,combined,2233,552,622,801,1975
417741.txt,combined,491,173,622,801,1596
421857.txt,combined,2116,542,622,801,1965
424609.txt,combined,5066,1163,622,801,2586
425070.txt,combined,549,168,622,801,1591
436641.txt,combined,5717,1373,622,801,2796
437522.txt,combined,2390,590,622,801,2013
438752.txt,combined,3149,841,622,801,2264
441995.txt,combined,2876,676,622,801,2099
44651.txt,combined,7091,1923,622,801,3346
446977.txt,combined,2633,691,622,801,2114
449018.txt,combined,3439,805,622,801,2228
451834.txt,combined,3840,960,622,801,2383
451971.txt,combined,2527,601,622,801,2024
454098.txt,combined,2179,531,622,801,1954
454921.txt,combined,3721,947,622,801,2370
458865.txt,combined,1522,375,622,801,1798
460075.txt,combined,1191,296,622,801,1719
460934.txt,combined,2550,653,622,801,2076
461429.txt,combined,2185,562,622,801,1985
465567.txt,combined,3189,852,622,801,2275
465626.txt,combined,556,135,622,801,1558
467893.txt,combined,4711,1210,622,801,2633
469158.txt,combined,2952,706,622,801,2129
474079.txt,combined,3737,905,622,801,2328
474844.txt,combined,2740,661,622,801,2084
479810.txt,combined,2971,728,622,801,2151
484722.txt,combined,2021,481,622,801,1904
486876.txt,combined,526,131,622,801,1554
488193.txt,combined,1878,476,622,801,1899
490657.txt,combined,3730,917,622,801,2340
491733.txt,combined,6520,1820,622,801,3243
493821.txt,combined,1657,422,622,801,1845
493824.txt,combined,3682,939,622,801,2362
505630.txt,combined,3837,939,622,801,2362
518791.txt,combined,2892,732,622,801,2155
519494.txt,combined,4260,968,622,801,2391
520978.txt,combined,3742,945,622,801,2368
521138.txt,combined,768,226,622,801,1649
521644.txt,combined,4254,1028,622,801,2451
524769.txt,combined,935,268,622,801,1691
529997.txt,combined,7489,2101,622,801,3524
534929.txt,combined,1307,313,622,801,1736
535790.txt,combined,502,136,622,801,1559
536666.txt,combined,2831,698,622,801,2121
544721.txt,combined,761,214,622,801,1637
548251.txt,combined,615,168,622,801,1591
548457.txt,combined,2158,514,622,801,1937
551914.txt,combined,6468,1594,622,801,3017
552746.txt,combined,3238,780,622,801,2203
552901.txt,combined,2070,513,622,801,1936
555942.txt,combined,2412,657,622,801,2080
556923.txt,combined,3828,957,622,801,2380
558397.txt,combined,2687,693,622,801,2116
561902.txt,combined,770,220,622,801,1643
56276.txt,combined,5103,1284,622,801,2707
564344.txt,combined,3106,762,622,801,2185
568216.txt,combined,3739,891,622,801,2314
571709.txt,combined,2226,589,622,801,2012
571923.txt,combined,2971,732,622,801,2155
572338.txt,combined,2369,538,622,801,1961
575788.txt,combined,4487,1186,622,801,2609
577218.txt,combined,3392,844,622,801,2267
579564.txt,combined,1306,311,622,801,1734
57971.txt,combined,2058,541,622,801,1964
580293.txt,combined,2787,686,622,801,2109
581492.txt,combined,3425,888,622,801,2311
583421.txt,combined,5298,1312,622,801,2735
584848.txt,combined,3270,818,622,801,2241
592315.txt,combined,3447,891,622,801,2314
592317.txt,combined,2901,672,622,801,2095
593910.txt,combined,2335,547,622,801,1970
598824.txt,combined,929,265,622,801,1688
59900.txt,combined,2006,482,622,801,1905
602299.txt,combined,3761,939,622,801,2362
605465.txt,combined,774,202,622,801,1625
607008.txt,combined,3257,818,622,801,2241
610810.txt,combined,3449,929,622,801,2352
615500.txt,combined,2500,603,622,801,2026
618683.txt,combined,2454,608,622,801,2031
62806.txt,combined,2439,582,622,801,2005
628178.txt,combined,3012,753,622,801,2176
628445.txt,combined,2738,675,622,801,2098
629036.txt,combined,5817,1405,622,801,2828
630726.txt,combined,4727,1171,622,801,2594
631720.txt,combined,4493,1074,622,801,2497
6369.txt,combined,2596,744,622,801,2167
637343.txt,combined,577,148,622,801,1571
639074.txt,combined,2509,558,622,801,1981
644397.txt,combined,3615,924,622,801,2347
646772.txt,combined,768,184,622,801,1607
651847.txt,combined,3700,946,622,801,2369
654327.txt,combined,1793,439,622,801,1862
655883.txt,combined,3118,720,622,801,2143
656981.txt,combined,3252,995,622,801,2418
665102.txt,combined,3698,908,622,801,2331
665419.txt,combined,3305,867,622,801,2290
667872.txt,combined,6073,1580,622,801,3003
669146.txt,combined,1806,421,622,801,1844
669316.txt,combined,3200,767,622,801,2190
673688.txt,combined,2139,484,622,801,1907
680227.txt,combined,1883,428,622,801,1851
688973.txt,combined,1506,410,622,801,1833
692769.txt,combined,4192,1064,622,801,2487
696524.txt,combined,1068,286,622,801,1709
700633.txt,combined,2645,648,622,801,2071
704145.txt,combined,4431,1195,622,801,2618
711775.txt,combined,2325,547,622,801,1970
713110.txt,combined,564,137,622,801,1560
71944.txt,combined,3122,741,622,801,2164
719809.txt,combined,3070,739,622,801,2162
722792.txt,combined,4999,1289,622,801,2712
724427.txt,combined,5507,1406,622,801,2829
72493.txt,combined,1476,396,622,801,1819
726562.txt,combined,2956,726,622,801,2149
731683.txt,combined,2196,542,622,801,1965
732291.txt,combined,1125,315,622,801,1738
732897.txt,combined,2195,505,622,801,1928
738401.txt,combined,3174,816,622,801,2239
738759.txt,combined,2456,611,622,801,2034
739007.txt,combined,2952,728,622,801,2151
739065.txt,combined,4459,1166,622,801,2589
742863.txt,combined,2380,603,622,801,2026
745421.txt,combined,2646,657,622,801,2080
747153.txt,combined,4180,1068,622,801,2491
752181.txt,combined,2348,603,622,801,2026
755397.txt,combined,1742,383,622,801,1806
756810.txt,combined,1531,385,622,801,1808
758933.txt,combined,4511,1096,622,801,2519
759432.txt,combined,2404,620,622,801,2043
760243.txt,combined,2780,753,622,801,2176
761628.txt,combined,3164,797,622,801,2220
761661.txt,combined,2345,549,622,801,1972
763380.txt,combined,6398,1718,622,801,3141
763510.txt,combined,4583,1184,622,801,2607
767722.txt,combined,3680,847,622,801,2270
771523.txt,combined,2519,624,622,801,2047
775865.txt,combined,6507,1529,622,801,2952
777248.txt,combined,3098,737,622,801,2160
7777.txt,combined,2290,560,622,801,1983
779143.txt,combined,3329,784,622,801,2207
782833.txt,combined,1790,431,622,801,1854
783891.txt,combined,2258,486,622,801,1909
784117.txt,combined,2667,642,622,801,2065
787338.txt,combined,1702,427,622,801,1850
787354.txt,combined,2072,534,622,801,1957
787603.txt,combined,3232,886,622,801,2309
795778.txt,combined,765,177,622,801,1600
801479.txt,combined,1626,379,622,801,1802
801535.txt,combined,566,156,622,801,1579
802950.txt,combined,2582,720,622,801,2143
803211.txt,combined,8069,2181,622,801,3604
804225.txt,combined,4202,1023,622,801,2446
808965.txt,combined,2308,612,622,801,2035
810748.txt,combined,5687,1432,622,801,2855
811013.txt,combined,2603,637,622,801,2060
816794.txt,combined,1485,526,622,801,1949
819290.txt,combined,5075,1164,622,801,2587
820516.txt,combined,4869,1167,622,801,2590
822853.txt,combined,3359,804,622,801,2227
824381.txt,combined,3284,825,622,801,2248
825950.txt,combined,2065,518,622,801,1941
830115.txt,combined,2859,724,622,801,2147
832253.txt,combined,863,230,622,801,1653
832366.txt,combined,470,126,622,801,1549
832391.txt,combined,4512,1159,622,801,2582
832888.txt,combined,1089,230,622,801,1653
833851.txt,combined,8550,2321,622,801,3744
836427.txt,combined,2563,636,622,801,2059
837503.txt,combined,2720,608,622,801,2031
837535.txt,combined,2149,577,622,801,2000
838461.txt,combined,1872,466,622,801,1889
840620.txt,combined,2360,642,622,801,2065
846904.txt,combined,5117,1255,622,801,2678
847829.txt,combined,4575,1081,622,801,2504
849051.txt,combined,2779,655,622,801,2078
851872.txt,combined,991,226,622,801,1649
853832.txt,combined,491,148,622,801,1571
856085.txt,combined,2107,557,622,801,1980
857282.txt,combined,3931,1016,622,801,2439
860978.txt,combined,559,137,622,801,1560
863118.txt,combined,2655,605,622,801,2028
863581.txt,combined,1442,306,622,801,1729
863584.txt,combined,3199,779,622,801,2202
863972.txt,combined,2831,716,622,801,2139
864996.txt,combined,2032,536,622,801,1959
865277.txt,combined,1674,418,622,801,1841
867143.txt,combined,630,178,622,801,1601
870535.txt,combined,3388,782,622,801,2205
870925.txt,combined,3590,925,622,801,2348
875152.txt,combined,2172,559,622,801,1982
882001.txt,combined,2760,698,622,801,2121
884999.txt,combined,2309,566,622,801,1989
888602.txt,combined,4562,1078,622,801,2501
891128.txt,combined,1271,351,622,801,1774
900465.txt,combined,3638,963,622,801,2386
900490.txt,combined,3427,877,622,801,2300
902720.txt,combined,3886,1053,622,801,2476
907559.txt,combined,2013,498,622,801,1921
907583.txt,combined,5418,1500,622,801,2923
907916.txt,combined,3010,755,622,801,2178
910092.txt,combined,3067,734,622,801,2157
911530.txt,combined,2555,623,622,801,2046
912141.txt,combined,4612,1271,622,801,2694
912580.txt,combined,3145,751,622,801,2174
9131.txt,combined,3960,1108,622,801,2531
919591.txt,combined,1474,339,622,801,1762
920788.txt,combined,2769,669,622,801,2092
924048.txt,combined,3838,981,622,801,2404
925650.txt,combined,4076,986,622,801,2409
928101.txt,combined,1814,393,622,801,1816
92967.txt,combined,1958,458,622,801,1881
930297.txt,combined,7768,2158,622,801,3581
932953.txt,combined,3117,778,622,801,2201
935281.txt,combined,2235,524,622,801,1947
936819.txt,combined,3399,867,622,801,2290
940450.txt,combined,4357,1149,622,801,2572
94714.txt,combined,752,194,622,801,1617
948790.txt,combined,2445,626,622,801,2049
950542.txt,combined,5485,1446,622,801,2869
957230.txt,combined,2733,682,622,801,2105
959920.txt,combined,834,237,622,801,1660
963098.txt,combined,2247,632,622,801,2055
964132.txt,combined,2785,656,622,801,2079
965945.txt,combined,749,200,622,801,1623
968639.txt,combined,3472,846,622,801,2269
970236.txt,combined,2989,710,622,801,2133
97134.txt,combined,1782,468,622,801,1891
972546.txt,combined,815,265,622,801,1688
972669.txt,combined,4444,1132,622,801,2555
973526.txt,combined,2221,593,622,801,2016
975096.txt,combined,3298,795,622,801,2218
975174.txt,combined,607,177,622,801,1600
980000.txt,combined,3292,816,622,801,2239
988682.txt,combined,3927,956,622,801,2379
990263.txt,combined,2850,669,622,801,2092
990489.txt,combined,1932,500,622,801,1923
991577.txt,combined,1522,380,622,801,1803
994799.txt,combined,2407,593,622,801,2016
996342.txt,combined,2134,527,622,801,1950
998834.txt,combined,3223,855,622,801,2278
999036.txt,combined,435,120,622,801,1543
1445467.txt,pathology,520,131,622,801,1554
667872.txt,pathology,1505,520,622,801,1943
1188128.txt,pathology,1070,381,622,801,1804
348061.txt,pathology,1869,472,622,801,1895
1263722.txt,pathology,662,154,622,801,1577
990489.txt,pathology,622,163,622,801,1586
1338180.txt,pathology,600,153,622,801,1576
1115749.txt,pathology,790,263,622,801,1686
385207.txt,pathology,3765,1105,622,801,2528
1244332.txt,pathology,628,156,622,801,1579
276261.txt,pathology,6503,2021,622,801,3444
1177630.txt,pathology,635,148,622,801,1571
1539606.txt,pathology,539,138,622,801,1561
1402243.txt,pathology,727,182,622,801,1605
950542.txt,pathology,2362,715,622,801,2138
618683.txt,pathology,1154,288,622,801,1711
521644.txt,pathology,1020,261,622,801,1684
656981.txt,pathology,3251,995,622,801,2418
536666.txt,pathology,587,150,622,801,1573
315566.txt,pathology,615,164,622,801,1587
1211203.txt,pathology,546,189,622,801,1612
244078.txt,pathology,968,247,622,801,1670
564344.txt,pathology,826,236,622,801,1659
1414906.txt,pathology,696,199,622,801,1622
1006301.txt,pathology,881,209,622,801,1632
722792.txt,pathology,832,222,622,801,1645
1332528.txt,pathology,868,266,622,801,1689
1311615.txt,pathology,762,183,622,801,1606
1646430.txt,pathology,1088,252,622,801,1675
109260.txt,pathology,672,178,622,801,1601
1513259.txt,pathology,523,131,622,801,1554
1347145.txt,pathology,1471,396,622,801,1819
1641810.txt,pathology,6312,1675,622,801,3098
1131291.txt,pathology,527,187,622,801,1610
1107828.txt,pathology,546,152,622,801,1575
1565302.txt,pathology,1136,295,622,801,1718
249456.txt,pathology,932,257,622,801,1680
1042445.txt,pathology,973,240,622,801,1663
1505227.txt,pathology,664,178,622,801,1601
1424073.txt,pathology,480,126,622,801,1549
465626.txt,pathology,555,135,622,801,1558
1109025.txt,pathology,639,187,622,801,1610
1486934.txt,pathology,602,158,622,801,1581
136458.txt,pathology,4896,1514,622,801,2937
1342311.txt,pathology,1440,385,622,801,1808
156086.txt,pathology,855,221,622,801,1644
999036.txt,pathology,434,120,622,801,1543
9131.txt,pathology,649,179,622,801,1602
1266899.txt,pathology,772,187,622,801,1610
1299439.txt,pathology,592,146,622,801,1569
1489909.txt,pathology,441,124,622,801,1547
277917.txt,pathology,712,236,622,801,1659
1503846.txt,pathology,1002,276,622,801,1699
108958.txt,pathology,685,171,622,801,1594
808965.txt,pathology,825,246,622,801,1669
1555261.txt,pathology,555,161,622,801,1584
454921.txt,pathology,917,238,622,801,1661
1173780.txt,pathology,622,158,622,801,1581
1452487.txt,pathology,629,168,622,801,1591
980000.txt,pathology,656,202,622,801,1625
1133805.txt,pathology,899,306,622,801,1729
846904.txt,pathology,529,176,622,801,1599
1114924.txt,pathology,414,130,622,801,1553
1406690.txt,pathology,562,151,622,801,1574
1406086.txt,pathology,505,139,622,801,1562
398501.txt,pathology,596,188,622,801,1611
1260134.txt,pathology,599,153,622,801,1576
637343.txt,pathology,576,148,622,801,1571
925650.txt,pathology,579,174,622,801,1597
1149638.txt,pathology,654,204,622,801,1627
1411132.txt,pathology,442,121,622,801,1544
1352387.txt,pathology,1175,281,622,801,1704
174746.txt,pathology,846,209,622,801,1632
125021.txt,pathology,748,205,622,801,1628
787603.txt,pathology,708,212,622,801,1635
1295667.txt,pathology,1124,264,622,801,1687
1239735.txt,pathology,541,138,622,801,1561
1410950.txt,pathology,594,151,622,801,1574
1332542.txt,pathology,1032,292,622,801,1715
1048022.txt,pathology,1990,620,622,801,2043
294180.txt,pathology,909,306,622,801,1729
152270.txt,pathology,548,140,622,801,1563
1028731.txt,pathology,571,180,622,801,1603
1504578.txt,pathology,466,126,622,801,1549
948790.txt,pathology,574,145,622,801,1568
41566.txt,pathology,759,191,622,801,1614
832391.txt,pathology,588,185,622,801,1608
742863.txt,pathology,819,212,622,801,1635
1203807.txt,pathology,719,222,622,801,1645
1176853.txt,pathology,951,265,622,801,1688
1128418.txt,pathology,694,200,622,801,1623
825950.txt,pathology,761,201,622,801,1624
1460110.txt,pathology,531,150,622,801,1573
1109413.txt,pathology,523,169,622,801,1592
1457897.txt,pathology,493,128,622,801,1551
126518.txt,pathology,737,194,622,801,1617
129701.txt,pathology,913,284,622,801,1707
1061513.txt,pathology,662,191,622,801,1614
996342.txt,pathology,626,155,622,801,1578
147889.txt,pathology,645,202,622,801,1625
907559.txt,pathology,648,161,622,801,1584
359824.txt,pathology,458,122,622,801,1545
1135804.txt,pathology,553,175,622,801,1598
1136997.txt,pathology,832,283,622,801,1706
571709.txt,pathology,1042,281,622,801,1704
884999.txt,pathology,733,182,622,801,1605
345750.txt,pathology,469,152,622,801,1575
244874.txt,pathology,1021,270,622,801,1693
1576809.txt,pathology,968,248,622,801,1671
832366.txt,pathology,475,127,622,801,1550
488193.txt,pathology,466,154,622,801,1577
1349074.txt,pathology,433,123,622,801,1546
1587596.txt,pathology,2248,687,622,801,2110
1031743.txt,pathology,4616,1457,622,801,2880
1082999.txt,pathology,5520,1514,622,801,2937
1164759.txt,pathology,624,206,622,801,1629
1163398.txt,pathology,482,122,622,801,1545
1024961.txt,pathology,642,216,622,801,1639
1384219.txt,pathology,929,221,622,801,1644
902720.txt,pathology,718,219,622,801,1642
1126450.txt,pathology,480,163,622,801,1586
1186824.txt,pathology,945,268,622,801,1691
692769.txt,pathology,478,161,622,801,1584
1570419.txt,pathology,621,175,622,801,1598
571923.txt,pathology,547,142,622,801,1565
1214634.txt,pathology,364,124,622,801,1547
1453403.txt,pathology,510,122,622,801,1545
1232897.txt,pathology,680,167,622,801,1590
322896.txt,pathology,590,190,622,801,1613
1279649.txt,pathology,3394,913,622,801,2336
1017733.txt,pathology,691,176,622,801,1599
1045725.txt,pathology,617,191,622,801,1614
1469478.txt,pathology,591,165,622,801,1588
646772.txt,pathology,767,184,622,801,1607
425070.txt,pathology,548,168,622,801,1591
288336.txt,pathology,563,142,622,801,1565
1205641.txt,pathology,586,190,622,801,1613
1401958.txt,pathology,555,137,622,801,1560
900490.txt,pathology,556,146,622,801,1569
306972.txt,pathology,725,221,622,801,1644
1095907.txt,pathology,456,147,622,801,1570
1302380.txt,pathology,7787,2247,622,801,3670
1649177.txt,pathology,430,117,622,801,1540
1119161.txt,pathology,861,244,622,801,1667
629036.txt,pathology,1454,382,622,801,1805
1125637.txt,pathology,1851,660,622,801,2083
940450.txt,pathology,4362,1150,622,801,2573
296602.txt,pathology,1347,465,622,801,1888
1264572.txt,pathology,850,196,622,801,1619
1586663.txt,pathology,679,197,622,801,1620
1472524.txt,pathology,1353,390,622,801,1813
454098.txt,pathology,480,115,622,801,1538
1189148.txt,pathology,831,251,622,801,1674
1501156.txt,pathology,420,114,622,801,1537
1122727.txt,pathology,628,181,622,801,1604
1465563.txt,pathology,880,254,622,801,1677
696524.txt,pathology,1067,286,622,801,1709
592315.txt,pathology,633,225,622,801,1648
1098029.txt,pathology,545,135,622,801,1558
1044430.txt,pathology,410,110,622,801,1533
1229797.txt,pathology,296,65,622,801,1488
551914.txt,pathology,1624,503,622,801,1926
1457934.txt,pathology,577,155,622,801,1578
1631415.txt,pathology,602,145,622,801,1568
836427.txt,pathology,564,146,622,801,1569
760243.txt,pathology,623,161,622,801,1584
252296.txt,pathology,539,153,622,801,1576
1142224.txt,pathology,538,188,622,801,1611
1181388.txt,pathology,1208,394,622,801,1817
1231206.txt,pathology,514,133,622,801,1556
1237993.txt,pathology,780,186,622,801,1609
1475415.txt,pathology,470,122,622,801,1545
1421457.txt,pathology,439,127,622,801,1550
1164060.txt,pathology,1426,350,622,801,1773
1269592.txt,pathology,1355,366,622,801,1789
867143.txt,pathology,629,178,622,801,1601
1374231.txt,pathology,598,156,622,801,1579
1132653.txt,pathology,588,192,622,801,1615
307869.txt,pathology,547,187,622,801,1610
1147322.txt,pathology,4494,1418,622,801,2841
1197023.txt,pathology,881,254,622,801,1677
1177122.txt,pathology,677,224,622,801,1647
1057509.txt,pathology,503,165,622,801,1588
520978.txt,pathology,496,142,622,801,1565
1331317.txt,pathology,606,140,622,801,1563
44651.txt,pathology,5264,1472,622,801,2895
577218.txt,pathology,958,278,622,801,1701
460934.txt,pathology,648,210,622,801,1633
1348408.txt,pathology,433,123,622,801,1546
1385239.txt,pathology,526,136,622,801,1559
1406838.txt,pathology,538,158,622,801,1581
1192207.txt,pathology,2064,597,622,801,2020
1517636.txt,pathology,531,136,622,801,1559
1246295.txt,pathology,530,132,622,801,1555
1568879.txt,pathology,947,219,622,801,1642
1120697.txt,pathology,675,211,622,801,1634
1093969.txt,pathology,617,159,622,801,1582
1287301.txt,pathology,507,147,622,801,1570
375374.txt,pathology,469,124,622,801,1547
759432.txt,pathology,1258,336,622,801,1759
1296140.txt,pathology,775,188,622,801,1611
1178863.txt,pathology,1111,336,622,801,1759
602299.txt,pathology,581,185,622,801,1608
837535.txt,pathology,435,131,622,801,1554
1611667.txt,pathology,832,234,622,801,1657
1144356.txt,pathology,495,142,622,801,1565
1442833.txt,pathology,1125,299,622,801,1722
758933.txt,pathology,1935,490,622,801,1913
1437043.txt,pathology,758,200,622,801,1623
1400559.txt,pathology,803,227,622,801,1650
386754.txt,pathology,464,123,622,801,1546
548251.txt,pathology,614,168,622,801,1591
1448793.txt,pathology,4180,1147,622,801,2570
875152.txt,pathology,561,138,622,801,1561
1247386.txt,pathology,516,135,622,801,1558
1131412.txt,pathology,758,195,622,801,1618
1560589.txt,pathology,1833,500,622,801,1923
655883.txt,pathology,742,167,622,801,1590
1435529.txt,pathology,753,202,622,801,1625
840620.txt,pathology,2359,642,622,801,2065
13428.txt,pathology,608,151,622,801,1574
279242.txt,pathology,666,155,622,801,1578
300560.txt,pathology,697,172,622,801,1595
401228.txt,pathology,1516,447,622,801,1870
752181.txt,pathology,594,162,622,801,1585
975174.txt,pathology,606,177,622,801,1600
1058395.txt,pathology,523,176,622,801,1599
1510013.txt,pathology,1371,342,622,801,1765
864996.txt,pathology,904,249,622,801,1672
1236616.txt,pathology,518,131,622,801,1554
1650881.txt,pathology,621,167,622,801,1590
1106938.txt,pathology,539,180,622,801,1603
141143.txt,pathology,532,138,622,801,1561
610810.txt,pathology,668,183,622,801,1606
963098.txt,pathology,473,150,622,801,1573
160444.txt,pathology,690,182,622,801,1605
968639.txt,pathology,1252,359,622,801,1782
1156440.txt,pathology,582,192,622,801,1615
1274025.txt,pathology,743,175,622,801,1598
165361.txt,pathology,4380,1213,622,801,2636
1611082.txt,pathology,465,127,622,801,1550
505630.txt,pathology,1417,404,622,801,1827
1153778.txt,pathology,455,160,622,801,1583
1510016.txt,pathology,579,145,622,801,1568
1031266.txt,pathology,505,135,622,801,1558
745421.txt,pathology,380,102,622,801,1525
1146143.txt,pathology,414,116,622,801,1539
518791.txt,pathology,683,222,622,801,1645
310511.txt,pathology,1027,278,622,801,1701
1146888.txt,pathology,1804,484,622,801,1907
1456720.txt,pathology,412,113,622,801,1536
1110794.txt,pathology,2241,645,622,801,2068
421857.txt,pathology,741,184,622,801,1607
1161635.txt,pathology,659,191,622,801,1614
1623163.txt,pathology,4544,1298,622,801,2721
1593669.txt,pathology,810,225,622,801,1648
1514775.txt,pathology,548,143,622,801,1566
1066995.txt,pathology,460,139,622,801,1562
437522.txt,pathology,657,158,622,801,1581
804225.txt,pathology,504,130,622,801,1553
1433822.txt,pathology,501,138,622,801,1561
1338382.txt,pathology,606,147,622,801,1570
704145.txt,pathology,782,252,622,801,1675
738401.txt,pathology,776,218,622,801,1641
803211.txt,pathology,5183,1472,622,801,2895
1143295.txt,pathology,577,188,622,801,1611
1009880.txt,pathology,537,133,622,801,1556
286563.txt,pathology,575,148,622,801,1571
137217.txt,pathology,534,141,622,801,1564
1127947.txt,pathology,3429,883,622,801,2306
144296.txt,pathology,551,140,622,801,1563
535790.txt,pathology,501,136,622,801,1559
1284179.txt,pathology,958,235,622,801,1658
555942.txt,pathology,546,178,622,801,1601
1175297.txt,pathology,718,212,622,801,1635
1120835.txt,pathology,1619,524,622,801,1947
1177082.txt,pathology,472,162,622,801,1585
801535.txt,pathology,565,156,622,801,1579
1457682.txt,pathology,3628,1041,622,801,2464
630726.txt,pathology,646,189,622,801,1612
1413925.txt,pathology,6651,1720,622,801,3143
1211374.txt,pathology,410,111,622,801,1534
853832.txt,pathology,490,148,622,801,1571
932953.txt,pathology,533,180,622,801,1603
833851.txt,pathology,4613,1396,622,801,2819
154306.txt,pathology,487,125,622,801,1548
1519382.txt,pathology,1690,457,622,801,1880
581492.txt,pathology,463,127,622,801,1550
313421.txt,pathology,463,132,622,801,1555
1430225.txt,pathology,756,206,622,801,1629
1454672.txt,pathology,652,174,622,801,1597
330399.txt,pathology,714,183,622,801,1606
417741.txt,pathology,490,173,622,801,1596
775865.txt,pathology,608,182,622,801,1605
30022.txt,pathology,551,192,622,801,1615
7777.txt,pathology,592,173,622,801,1596
732291.txt,pathology,353,117,622,801,1540
1366321.txt,pathology,1452,415,622,801,1838
830115.txt,pathology,834,233,622,801,1656
112340.txt,pathology,539,176,622,801,1599
1155412.txt,pathology,904,259,622,801,1682
1489662.txt,pathology,960,252,622,801,1675
157156.txt,pathology,5155,1435,622,801,2858
822853.txt,pathology,1040,265,622,801,1688
1218398.txt,pathology,745,211,622,801,1634
1160623.txt,pathology,479,159,622,801,1582
1078774.txt,pathology,892,266,622,801,1689
771523.txt,pathology,669,187,622,801,1610
1384866.txt,pathology,492,136,622,801,1559
1230627.txt,pathology,1882,473,622,801,1896
467893.txt,pathology,920,313,622,801,1736
1399697.txt,pathology,368,99,622,801,1522
210505.txt,pathology,533,148,622,801,1571
376941.txt,pathology,1071,300,622,801,1723
227464.txt,pathology,633,157,622,801,1580
1525413.txt,pathology,583,142,622,801,1565
1579197.txt,pathology,789,196,622,801,1619
179936.txt,pathology,5092,1473,622,801,2896
1149446.txt,pathology,1879,616,622,801,2039
258141.txt,pathology,1018,268,622,801,1691
1172619.txt,pathology,689,246,622,801,1669
1427932.txt,pathology,1377,381,622,801,1804
556923.txt,pathology,780,216,622,801,1639
1514079.txt,pathology,438,113,622,801,1536
583421.txt,pathology,2143,589,622,801,2012
1476181.txt,pathology,638,157,622,801,1580
1244601.txt,pathology,715,193,622,801,1616
1562677.txt,pathology,688,177,622,801,1600
307204.txt,pathology,627,200,622,801,1623
1475978.txt,pathology,433,119,622,801,1542
103122.txt,pathology,510,138,622,801,1561
1336513.txt,pathology,597,164,622,801,1587
1243481.txt,pathology,567,144,622,801,1567
134424.txt,pathology,757,277,622,801,1700
168146.txt,pathology,589,158,622,801,1581
1365459.txt,pathology,3135,873,622,801,2296
552746.txt,pathology,606,151,622,801,1574
1277035.txt,pathology,654,185,622,801,1608
1445486.txt,pathology,908,258,622,801,1681
1393583.txt,pathology,2319,602,622,801,2025
461429.txt,pathology,1083,290,622,801,1713
361167.txt,pathology,996,303,622,801,1726
292261.txt,pathology,504,143,622,801,1566
206783.txt,pathology,594,183,622,801,1606
57971.txt,pathology,444,128,622,801,1551
1442355.txt,pathology,575,153,622,801,1576
882001.txt,pathology,511,139,622,801,1562
1142707.txt,pathology,860,262,622,801,1685
170012.txt,pathology,595,190,622,801,1613
438752.txt,pathology,903,311,622,801,1734
1254757.txt,pathology,2336,661,622,801,2084
493824.txt,pathology,861,265,622,801,1688
784117.txt,pathology,752,188,622,801,1611
1215113.txt,pathology,2889,968,622,801,2391
236853.txt,pathology,941,321,622,801,1744
1444811.txt,pathology,536,137,622,801,1560
998834.txt,pathology,580,165,622,801,1588
245815.txt,pathology,5171,1370,622,801,2793
580293.txt,pathology,656,176,622,801,1599
1281645.txt,pathology,1461,406,622,801,1829
973526.txt,pathology,543,159,622,801,1582
1435525.txt,pathology,837,243,622,801,1666
334421.txt,pathology,924,260,622,801,1683
1177351.txt,pathology,609,177,622,801,1600
436641.txt,pathology,1076,281,622,801,1704
1208233.txt,pathology,757,220,622,801,1643
1226244.txt,pathology,1900,515,622,801,1938
1296972.txt,pathology,594,165,622,801,1588
100150.txt,pathology,967,275,622,801,1698
333937.txt,pathology,568,150,622,801,1573
388442.txt,pathology,581,186,622,801,1609
1387465.txt,pathology,2418,625,622,801,2048
738759.txt,pathology,720,197,622,801,1620
1046098.txt,pathology,462,147,622,801,1570
1237434.txt,pathology,736,168,622,801,1591
1262059.txt,pathology,574,154,622,801,1577
1291361.txt,pathology,614,147,622,801,1570
824381.txt,pathology,524,136,622,801,1559
529997.txt,pathology,4434,1429,622,801,2852
166906.txt,pathology,655,156,622,801,1579
1105247.txt,pathology,652,181,622,801,1604
1294458.txt,pathology,755,215,622,801,1638
820516.txt,pathology,405,107,622,801,1530
36311.txt,pathology,802,249,622,801,1672
1426731.txt,pathology,789,189,622,801,1612
584848.txt,pathology,924,288,622,801,1711
1229304.txt,pathology,796,195,622,801,1618
223514.txt,pathology,1049,268,622,801,1691
700633.txt,pathology,496,127,622,801,1550
1346920.txt,pathology,966,267,622,801,1690
1548859.txt,pathology,764,224,622,801,1647
930297.txt,pathology,5143,1483,622,801,2906
810748.txt,pathology,771,284,622,801,1707
524769.txt,pathology,934,268,622,801,1691
1458541.txt,pathology,785,209,622,801,1632
1361136.txt,pathology,1609,427,622,801,1850
446977.txt,pathology,862,214,622,801,1637
1083442.txt,pathology,1970,550,622,801,1973
1181132.txt,pathology,1005,335,622,801,1758
276343.txt,pathology,1446,456,622,801,1879
188433.txt,pathology,490,128,622,801,1551
1292894.txt,pathology,2637,682,622,801,2105
870925.txt,pathology,1155,307,622,801,1730
761628.txt,pathology,744,200,622,801,1623
631720.txt,pathology,476,168,622,801,1591
1237652.txt,pathology,705,199,622,801,1622
1021737.txt,pathology,3881,1217,622,801,2640
1174467.txt,pathology,471,155,622,801,1578
900465.txt,pathology,399,131,622,801,1554
381460.txt,pathology,1311,344,622,801,1767
414957.txt,pathology,545,135,622,801,1558
1127404.txt,pathology,1063,305,622,801,1728
1456142.txt,pathology,575,139,622,801,1562
138482.txt,pathology,860,301,622,801,1724
1334220.txt,pathology,2315,582,622,801,2005
1347153.txt,pathology,605,159,622,801,1582
324434.txt,pathology,1490,411,622,801,1834
1223664.txt,pathology,947,262,622,801,1685
1395126.txt,pathology,534,152,622,801,1575
1303763.txt,pathology,378,102,622,801,1525
1051911.txt,pathology,969,259,622,801,1682
1468262.txt,pathology,1923,531,622,801,1954
615500.txt,pathology,496,127,622,801,1550
628178.txt,pathology,913,233,622,801,1656
1208740.txt,pathology,1626,507,622,801,1930
1328441.txt,pathology,3994,1102,622,801,2525
558397.txt,pathology,479,124,622,801,1547
474079.txt,pathology,569,144,622,801,1567
972669.txt,pathology,1692,464,622,801,1887
1194749.txt,pathology,712,216,622,801,1639
1109080.txt,pathology,666,196,622,801,1619
863584.txt,pathology,1193,275,622,801,1698
1100399.txt,pathology,627,185,622,801,1608
486876.txt,pathology,525,131,622,801,1554
187518.txt,pathology,727,223,622,801,1646
1549397.txt,pathology,969,264,622,801,1687
1223322.txt,pathology,726,218,622,801,1641
1348463.txt,pathology,1074,279,622,801,1702
392130.txt,pathology,609,150,622,801,1573
739065.txt,pathology,1664,493,622,801,1916
1331038.txt,pathology,525,131,622,801,1554
888602.txt,pathology,1520,366,622,801,1789
1362878.txt,pathology,4899,1349,622,801,2772
787338.txt,pathology,452,114,622,801,1537
598824.txt,pathology,928,265,622,801,1688
1189263.txt,pathology,856,243,622,801,1666
1445052.txt,pathology,661,167,622,801,1590
1416427.txt,pathology,2404,662,622,801,2085
1205840.txt,pathology,746,223,622,801,1646
1453377.txt,pathology,602,190,622,801,1613
1204131.txt,pathology,1563,522,622,801,1945
1378907.txt,pathology,1134,322,622,801,1745
891128.txt,pathology,1271,351,622,801,1774
1586860.txt,pathology,635,180,622,801,1603
1591620.txt,pathology,694,173,622,801,1596
1104512.txt,pathology,466,125,622,801,1548
1183186.txt,pathology,597,194,622,801,1617
1093699.txt,pathology,568,147,622,801,1570
242907.txt,pathology,589,168,622,801,1591
1416988.txt,pathology,394,105,622,801,1528
857282.txt,pathology,721,215,622,801,1638
1399434.txt,pathology,556,150,622,801,1573
1629212.txt,pathology,744,191,622,801,1614
1264635.txt,pathology,513,132,622,801,1555
1048782.txt,pathology,668,159,622,801,1582
907583.txt,pathology,2639,806,622,801,2229
1007502.txt,pathology,460,129,622,801,1552
1212081.txt,pathology,679,180,622,801,1603
347246.txt,pathology,644,167,622,801,1590
747153.txt,pathology,601,205,622,801,1628
713110.txt,pathology,563,137,622,801,1560
1545677.txt,pathology,851,247,622,801,1670
1529931.txt,pathology,529,137,622,801,1560
1317057.txt,pathology,697,178,622,801,1601
1322881.txt,pathology,726,197,622,801,1620
1289908.txt,pathology,890,250,622,801,1673
242635.txt,pathology,605,160,622,801,1583
110054.txt,pathology,828,249,622,801,1672
856085.txt,pathology,550,186,622,801,1609
1328286.txt,pathology,5658,1610,622,801,3033
1120796.txt,pathology,523,157,622,801,1580
912141.txt,pathology,2506,759,622,801,2182
357871.txt,pathology,558,182,622,801,1605
1336918.txt,pathology,825,223,622,801,1646
1414617.txt,pathology,541,147,622,801,1570
1261144.txt,pathology,572,149,622,801,1572
763380.txt,pathology,4445,1230,622,801,2653
1186884.txt,pathology,3134,986,622,801,2409
1538245.txt,pathology,456,117,622,801,1540
1524429.txt,pathology,764,221,622,801,1644
1185576.txt,pathology,526,137,622,801,1560
1254308.txt,pathology,655,187,622,801,1610
1547573.txt,pathology,942,284,622,801,1707
267658.txt,pathology,812,245,622,801,1668
860978.txt,pathology,558,137,622,801,1560
1098748.txt,pathology,1724,436,622,801,1859
731683.txt,pathology,496,132,622,801,1555
568216.txt,pathology,452,149,622,801,1572
1219243.txt,pathology,448,154,622,801,1577
59900.txt,pathology,564,129,622,801,1552
1470637.txt,pathology,451,124,622,801,1547
1312475.txt,pathology,755,186,622,801,1609
777248.txt,pathology,659,161,622,801,1584
1190812.txt,pathology,861,261,622,801,1684
1333587.txt,pathology,526,130,622,801,1553
1626006.txt,pathology,695,190,622,801,1613
1110577.txt,pathology,1142,340,622,801,1763
1113863.txt,pathology,706,198,622,801,1621
957230.txt,pathology,480,161,622,801,1584
1274985.txt,pathology,644,185,622,801,1608
1618327.txt,pathology,1378,354,622,801,1777
1285492.txt,pathology,3827,1052,622,801,2475
1050994.txt,pathology,2049,635,622,801,2058
575788.txt,pathology,535,184,622,801,1607
1466419.txt,pathology,473,130,622,801,1553
1290087.txt,pathology,1741,538,622,801,1961
135560.txt,pathology,1387,353,622,801,1776
484722.txt,pathology,419,111,622,801,1534
787354.txt,pathology,546,171,622,801,1594
1044448.txt,pathology,532,138,622,801,1561
1041684.txt,pathology,674,203,622,801,1626
1259672.txt,pathology,522,132,622,801,1555
123483.txt,pathology,470,148,622,801,1571
1445040.txt,pathology,713,175,622,801,1598
183957.txt,pathology,1280,325,622,801,1748
469158.txt,pathology,713,193,622,801,1616
1177148.txt,pathology,585,192,622,801,1615
1621194.txt,pathology,953,288,622,801,1711
368373.txt,pathology,1063,318,622,801,1741
1100595.txt,pathology,572,186,622,801,1609
1548478.txt,pathology,452,119,622,801,1542
491733.txt,pathology,2481,749,622,801,2172
56276.txt,pathology,479,162,622,801,1585
1147283.txt,pathology,454,159,622,801,1582
1090241.txt,pathology,428,110,622,801,1533
1503544.txt,pathology,3545,1008,622,801,2431
1447975.txt,pathology,575,160,622,801,1583
1246520.txt,pathology,632,143,622,801,1566
1145024.txt,pathology,756,206,622,801,1629
1309309.txt,pathology,1726,499,622,801,1922
1130120.txt,pathology,3943,1185,622,801,2608
1138298.txt,pathology,629,188,622,801,1611
607008.txt,pathology,679,230,622,801,1653
1460055.txt,pathology,398,114,622,801,1537
1224467.txt,pathology,555,191,622,801,1614
6369.txt,pathology,778,263,622,801,1686
1358956.txt,pathology,713,186,622,801,1609
924048.txt,pathology,860,297,622,801,1720
665419.txt,pathology,3304,867,622,801,2290
479810.txt,pathology,746,199,622,801,1622
1247526.txt,pathology,632,164,622,801,1587
1262214.txt,pathology,705,165,622,801,1588
1004073.txt,pathology,514,128,622,801,1551
975096.txt,pathology,513,166,622,801,1589
1406291.txt,pathology,639,155,622,801,1578
490657.txt,pathology,1427,376,622,801,1799
1437599.txt,pathology,556,156,622,801,1579
724427.txt,pathology,710,242,622,801,1665
1130580.txt,pathology,560,180,622,801,1603
381326.txt,pathology,694,192,622,801,1615
1364626.txt,pathology,567,156,622,801,1579
245845.txt,pathology,1101,304,622,801,1727
1089523.txt,pathology,3776,1055,622,801,2478
1311697.txt,pathology,1051,254,622,801,1677
1354965.txt,pathology,494,133,622,801,1556
1362929.txt,pathology,657,162,622,801,1585
307557.txt,pathology,1387,390,622,801,1813
552901.txt,pathology,605,154,622,801,1577
1431251.txt,pathology,551,144,622,801,1567
220399.txt,pathology,464,121,622,801,1544
936819.txt,pathology,726,218,622,801,1641
1145281.txt,pathology,513,148,622,801,1571
763510.txt,pathology,848,224,622,801,1647
1271901.txt,pathology,447,121,622,801,1544
1290087.txt,consult,1574,354,622,801,1777
558397.txt,consult,2207,569,622,801,1992
936819.txt,consult,2672,649,622,801,2072
907583.txt,consult,2778,694,622,801,2117
1546177.txt,consult,795,242,622,801,1665
521644.txt,consult,3233,767,622,801,2190
1184300.txt,consult,816,195,622,801,1618
1037530.txt,consult,3527,826,622,801,2249
825950.txt,consult,1310,318,622,801,1741
1117087.txt,consult,1881,497,622,801,1920
925650.txt,consult,3496,812,622,801,2235
1078774.txt,consult,3915,958,622,801,2381
991577.txt,consult,1522,380,622,801,1803
1621194.txt,consult,3164,790,622,801,2213
1172619.txt,consult,4374,995,622,801,2418
322896.txt,consult,2278,508,622,801,1931
361167.txt,consult,2317,551,622,801,1974
1504578.txt,consult,1870,508,622,801,1931
323112.txt,consult,1577,368,622,801,1791
1510079.txt,consult,1511,380,622,801,1803
479810.txt,consult,2231,530,622,801,1953
1296140.txt,consult,3154,849,622,801,2272
1610461.txt,consult,1205,296,622,801,1719
235538.txt,consult,3612,806,622,801,2229
1451513.txt,consult,2283,547,622,801,1970
1233017.txt,consult,2968,667,622,801,2090
1274985.txt,consult,2216,567,622,801,1990
763380.txt,consult,1952,488,622,801,1911
333937.txt,consult,1326,317,622,801,1740
1277636.txt,consult,849,232,622,801,1655
410264.txt,consult,1650,421,622,801,1844
1147322.txt,consult,3055,725,622,801,2148
1393583.txt,consult,1851,512,622,801,1935
175401.txt,consult,816,233,622,801,1656
1074265.txt,consult,4887,1096,622,801,2519
863581.txt,consult,1442,306,622,801,1729
1140774.txt,consult,4938,1204,622,801,2627
583421.txt,consult,3160,724,622,801,2147
1221482.txt,consult,3452,860,622,801,2283
1153778.txt,consult,1852,416,622,801,1839
1143295.txt,consult,2111,450,622,801,1873
1424359.txt,consult,1158,285,622,801,1708
296213.txt,consult,804,207,622,801,1630
296602.txt,consult,3520,796,622,801,2219
1205641.txt,consult,2065,495,622,801,1918
1243118.txt,consult,2245,509,622,801,1932
1213444.txt,consult,2207,530,622,801,1953
100729.txt,consult,2940,717,622,801,2140
552746.txt,consult,2637,630,622,801,2053
1262214.txt,consult,1411,341,622,801,1764
856085.txt,consult,1556,371,622,801,1794
965945.txt,consult,782,200,622,801,1623
875152.txt,consult,1620,422,622,801,1845
1538245.txt,consult,1599,402,622,801,1825
629036.txt,consult,4362,1023,622,801,2446
1113863.txt,consult,2381,572,622,801,1995
1597827.txt,consult,1938,480,622,801,1903
1080401.txt,consult,2653,614,622,801,2037
1448793.txt,consult,2430,621,622,801,2044
1436630.txt,consult,792,244,622,801,1667
811013.txt,consult,2603,637,622,801,2060
1105247.txt,consult,3548,765,622,801,2188
907916.txt,consult,3010,755,622,801,2178
1514079.txt,consult,2664,645,622,801,2068
1547573.txt,consult,3910,1019,622,801,2442
134424.txt,consult,3260,783,622,801,2206
307204.txt,consult,3390,806,622,801,2229
1331317.txt,consult,4991,1151,622,801,2574
1095907.txt,consult,2449,602,622,801,2025
183957.txt,consult,1861,478,622,801,1901
719809.txt,consult,3070,739,622,801,2162
1177122.txt,consult,1963,463,622,801,1886
888602.txt,consult,3048,713,622,801,2136
150951.txt,consult,1242,298,622,801,1721
1007502.txt,consult,1790,482,622,801,1905
1120697.txt,consult,2873,663,622,801,2086
1273369.txt,consult,1725,402,622,801,1825
752181.txt,consult,1760,442,622,801,1865
1127947.txt,consult,3866,980,622,801,2403
1164033.txt,consult,5674,1296,622,801,2719
957230.txt,consult,2252,521,622,801,1944
1569326.txt,consult,2351,574,622,801,1997
174746.txt,consult,1907,470,622,801,1893
1496490.txt,consult,1537,359,622,801,1782
1132653.txt,consult,2224,507,622,801,1930
1110794.txt,consult,1970,495,622,801,1918
692769.txt,consult,3713,903,622,801,2326
1269592.txt,consult,3676,951,622,801,2374
738401.txt,consult,2403,599,622,801,2022
669316.txt,consult,3200,767,622,801,2190
948790.txt,consult,1870,481,622,801,1904
1108098.txt,consult,3016,706,622,801,2129
294180.txt,consult,3083,660,622,801,2083
244688.txt,consult,1710,393,622,801,1816
1128418.txt,consult,2660,616,622,801,2039
461429.txt,consult,1107,273,622,801,1696
307557.txt,consult,1847,457,622,801,1880
1109413.txt,consult,1911,461,622,801,1884
1189148.txt,consult,4788,1069,622,801,2492
548457.txt,consult,2158,514,622,801,1937
1016391.txt,consult,1573,376,622,801,1799
783891.txt,consult,2258,486,622,801,1909
138405.txt,consult,1479,359,622,801,1782
1329878.txt,consult,2530,602,622,801,2025
932953.txt,consult,2583,598,622,801,2021
165361.txt,consult,786,194,622,801,1617
1465563.txt,consult,2732,697,622,801,2120
864996.txt,consult,1128,287,622,801,1710
1673510.txt,consult,832,218,622,801,1641
846904.txt,consult,4587,1079,622,801,2502
1259672.txt,consult,2829,703,622,801,2126
388442.txt,consult,2837,671,622,801,2094
577218.txt,consult,2433,566,622,801,1989
1562677.txt,consult,2444,569,622,801,1992
1135804.txt,consult,3349,802,622,801,2225
1259610.txt,consult,2726,653,622,801,2076
1336513.txt,consult,2973,767,622,801,2190
110054.txt,consult,4826,1199,622,801,2622
571709.txt,consult,1183,308,622,801,1731
1133061.txt,consult,2855,661,622,801,2084
1169327.txt,consult,2439,586,622,801,2009
1177082.txt,consult,1535,356,622,801,1779
1114924.txt,consult,2293,533,622,801,1956
544721.txt,consult,794,215,622,801,1638
1281645.txt,consult,1528,364,622,801,1787
1237068.txt,consult,3000,744,622,801,2167
1070247.txt,consult,2084,513,622,801,1936
1307534.txt,consult,2034,515,622,801,1938
1424032.txt,consult,2011,497,622,801,1920
1454672.txt,consult,1930,490,622,801,1913
1370838.txt,consult,2752,706,622,801,2129
1120835.txt,consult,1987,444,622,801,1867
1090241.txt,consult,1897,489,622,801,1912
838461.txt,consult,1872,466,622,801,1889
1109025.txt,consult,3066,728,622,801,2151
1236616.txt,consult,1297,338,622,801,1761
1370858.txt,consult,1307,316,622,801,1739
1322650.txt,consult,2364,559,622,801,1982
1093969.txt,consult,3643,909,622,801,2332
1266668.txt,consult,1901,430,622,801,1853
592317.txt,consult,2901,672,622,801,2095
581492.txt,consult,2961,761,622,801,2184
1107810.txt,consult,1628,369,622,801,1792
1501156.txt,consult,2174,589,622,801,2012
1442833.txt,consult,2126,566,622,801,1989
592315.txt,consult,2813,666,622,801,2089
1100399.txt,consult,3492,811,622,801,2234
1149638.txt,consult,2498,609,622,801,2032
1548478.txt,consult,1769,437,622,801,1860
1223322.txt,consult,1496,369,622,801,1792
1020709.txt,consult,1657,374,622,801,1797
688973.txt,consult,1506,410,622,801,1833
1406086.txt,consult,3129,832,622,801,2255
1175297.txt,consult,2548,623,622,801,2046
1514775.txt,consult,3046,773,622,801,2196
1300290.txt,consult,3132,758,622,801,2181
1065359.txt,consult,761,188,622,801,1611
615500.txt,consult,2012,477,622,801,1900
1042445.txt,consult,1640,389,622,801,1812
1164060.txt,consult,3280,842,622,801,2265
700633.txt,consult,2148,521,622,801,1944
1424073.txt,consult,2116,501,622,801,1924
1442020.txt,consult,1309,351,622,801,1774
392130.txt,consult,1933,452,622,801,1875
474079.txt,consult,3167,761,622,801,2184
113004.txt,consult,813,238,622,801,1661
7777.txt,consult,1697,387,622,801,1810
779143.txt,consult,3329,784,622,801,2207
12144.txt,consult,3275,765,622,801,2188
1239735.txt,consult,1908,434,622,801,1857
1174467.txt,consult,2144,491,622,801,1914
227464.txt,consult,2705,662,622,801,2085
1082999.txt,consult,1737,433,622,801,1856
474844.txt,consult,2740,661,622,801,2084
1501323.txt,consult,1591,400,622,801,1823
1343542.txt,consult,1234,316,622,801,1739
536666.txt,consult,2251,549,622,801,1972
194033.txt,consult,2275,597,622,801,2020
1244601.txt,consult,2140,525,622,801,1948
1232897.txt,consult,983,342,622,801,1765
330928.txt,consult,2779,639,622,801,2062
1219243.txt,consult,4129,964,622,801,2387
484722.txt,consult,1601,370,622,801,1793
1315408.txt,consult,2600,620,622,801,2043
1155412.txt,consult,2271,575,622,801,1998
1435529.txt,consult,1820,481,622,801,1904
919591.txt,consult,1474,339,622,801,1762
1017733.txt,consult,3392,839,622,801,2262
398501.txt,consult,2284,573,622,801,1996
1194749.txt,consult,3234,783,622,801,2206
313421.txt,consult,2693,698,622,801,2121
863972.txt,consult,2832,717,622,801,2140
1298270.txt,consult,1609,407,622,801,1830
1222698.txt,consult,3474,838,622,801,2261
1574092.txt,consult,4423,1089,622,801,2512
1667104.txt,consult,791,223,622,801,1646
1246295.txt,consult,2084,508,622,801,1931
1324719.txt,consult,1364,353,622,801,1776
1629212.txt,consult,1290,315,622,801,1738
837535.txt,consult,1713,446,622,801,1869
1700089.txt,consult,777,188,622,801,1611
644397.txt,consult,3615,924,622,801,2347
832391.txt,consult,3923,974,622,801,2397
94714.txt,consult,785,194,622,801,1617
618683.txt,consult,1299,320,622,801,1743
722792.txt,consult,4166,1067,622,801,2490
1214634.txt,consult,4129,1027,622,801,2450
631720.txt,consult,4016,906,622,801,2329
1167024.txt,consult,3199,776,622,801,2199
782833.txt,consult,1790,431,622,801,1854
1296972.txt,consult,2798,703,622,801,2126
998834.txt,consult,2642,690,622,801,2113
602299.txt,consult,3179,754,622,801,2177
1122727.txt,consult,3186,757,622,801,2180
1223664.txt,consult,1442,358,622,801,1781
1147283.txt,consult,2331,517,622,801,1940
801479.txt,consult,1626,379,622,801,1802
1257269.txt,consult,2593,607,622,801,2030
1457682.txt,consult,1739,420,622,801,1843
1319384.txt,consult,1183,286,622,801,1709
1555261.txt,consult,1450,375,622,801,1798
1131291.txt,consult,2781,637,622,801,2060
907559.txt,consult,1371,338,622,801,1761
343698.txt,consult,3054,742,622,801,2165
1452487.txt,consult,1519,399,622,801,1822
665102.txt,consult,3698,908,622,801,2331
990263.txt,consult,2850,669,622,801,2092
1178863.txt,consult,2546,645,622,801,2068
1429383.txt,consult,1379,321,622,801,1744
994799.txt,consult,2407,593,622,801,2016
1384219.txt,consult,1184,295,622,801,1718
1365459.txt,consult,2145,503,622,801,1926
1227068.txt,consult,3685,857,622,801,2280
1127404.txt,consult,3509,858,622,801,2281
1057509.txt,consult,2700,660,622,801,2083
534929.txt,consult,1307,313,622,801,1736
1466419.txt,consult,1770,456,622,801,1879
870535.txt,consult,3388,782,622,801,2205
1346920.txt,consult,1508,361,622,801,1784
968639.txt,consult,2219,487,622,801,1910
1215254.txt,consult,1679,394,622,801,1817
359824.txt,consult,2870,802,622,801,2225
1106938.txt,consult,4592,1082,622,801,2505
975096.txt,consult,2784,629,622,801,2052
242635.txt,consult,1536,373,622,801,1796
1548859.txt,consult,2410,632,622,801,2055
1096098.txt,consult,3563,810,622,801,2233
963098.txt,consult,1773,482,622,801,1905
446977.txt,consult,1770,477,622,801,1900
1416988.txt,consult,1609,430,622,801,1853
680227.txt,consult,1883,428,622,801,1851
1077071.txt,consult,2365,535,622,801,1958
36311.txt,consult,2088,506,622,801,1929
103122.txt,consult,1757,429,622,801,1852
1445486.txt,consult,1758,496,622,801,1919
1586860.txt,consult,1565,416,622,801,1839
288336.txt,consult,2395,590,622,801,2013
92967.txt,consult,1958,458,622,801,1881
1328441.txt,consult,2515,583,622,801,2006
1297318.txt,consult,1472,362,622,801,1785
972546.txt,consult,848,266,622,801,1689
1411132.txt,consult,3486,878,622,801,2301
1348408.txt,consult,4165,1068,622,801,2491
1162274.txt,consult,3364,802,622,801,2225
236853.txt,consult,3141,724,622,801,2147
555942.txt,consult,1865,479,622,801,1902
1138298.txt,consult,2254,507,622,801,1930
742863.txt,consult,1560,391,622,801,1814
863118.txt,consult,2655,605,622,801,2028
787354.txt,consult,1525,363,622,801,1786
62806.txt,consult,2439,582,622,801,2005
41566.txt,consult,1473,361,622,801,1784
572338.txt,consult,2369,538,622,801,1961
469158.txt,consult,2238,513,622,801,1936
1340671.txt,consult,1351,347,622,801,1770
972669.txt,consult,2758,668,622,801,2091
1347145.txt,consult,2606,620,622,801,2043
996342.txt,consult,1507,372,622,801,1795
136038.txt,consult,4611,1138,622,801,2561
368373.txt,consult,2210,519,622,801,1942
1421695.txt,consult,1822,471,622,801,1894
832253.txt,consult,896,230,622,801,1653
505630.txt,consult,2419,535,622,801,1958
1156267.txt,consult,2248,558,622,801,1981
1022364.txt,consult,2817,715,622,801,2138
732291.txt,consult,771,198,622,801,1621
1289606.txt,consult,1463,371,622,801,1794
249456.txt,consult,939,258,622,801,1681
1445052.txt,consult,1638,386,622,801,1809
1230627.txt,consult,2187,569,622,801,1992
1402243.txt,consult,2422,582,622,801,2005
1247694.txt,consult,4190,1020,622,801,2443
1109080.txt,consult,2707,626,622,801,2049
1289220.txt,consult,3921,934,622,801,2357
330399.txt,consult,2669,629,622,801,2052
1529931.txt,consult,2057,500,622,801,1923
378985.txt,consult,897,233,622,801,1656
1354965.txt,consult,1555,399,622,801,1822
1083411.txt,consult,2674,623,622,801,2046
1149446.txt,consult,2554,635,622,801,2058
1197023.txt,consult,4484,1094,622,801,2517
1150440.txt,consult,2358,575,622,801,1998
724427.txt,consult,4796,1164,622,801,2587
1048782.txt,consult,1923,479,622,801,1902
1092052.txt,consult,3472,825,622,801,2248
1082505.txt,consult,2071,481,622,801,1904
739065.txt,consult,2794,673,622,801,2096
1539606.txt,consult,1164,304,622,801,1727
1399385.txt,consult,1332,328,622,801,1751
307869.txt,consult,3131,761,622,801,2184
1457934.txt,consult,2011,543,622,801,1966
1120796.txt,consult,3997,964,622,801,2387
1384866.txt,consult,3391,823,622,801,2246
1144356.txt,consult,1544,358,622,801,1781
628445.txt,consult,2738,675,622,801,2098
1437043.txt,consult,1426,342,622,801,1765
836427.txt,consult,1998,490,622,801,1913
1252653.txt,consult,1063,268,622,801,1691
310511.txt,consult,1923,455,622,801,1878
605465.txt,consult,774,202,622,801,1625
1171744.txt,consult,3134,736,622,801,2159
928101.txt,consult,1814,393,622,801,1816
331375.txt,consult,2771,686,622,801,2109
223514.txt,consult,1556,399,622,801,1822
607008.txt,consult,2577,588,622,801,2011
593910.txt,consult,2335,547,622,801,1970
1145281.txt,consult,2159,529,622,801,1952
386754.txt,consult,1466,372,622,801,1795
1410950.txt,consult,2317,616,622,801,2039
784117.txt,consult,1922,455,622,801,1878
1505227.txt,consult,2247,551,622,801,1974
1453403.txt,consult,2087,513,622,801,1936
421857.txt,consult,1381,359,622,801,1782
1177351.txt,consult,1985,468,622,801,1891
1401958.txt,consult,1567,408,622,801,1831
819290.txt,consult,5075,1164,622,801,2587
1063176.txt,consult,3565,841,622,801,2264
1330775.txt,consult,2102,495,622,801,1918
1093699.txt,consult,1284,311,622,801,1734
1291053.txt,consult,1685,390,622,801,1813
210505.txt,consult,1742,455,622,801,1878
1119161.txt,consult,1812,407,622,801,1830
1421457.txt,consult,4179,964,622,801,2387
1132082.txt,consult,5655,1348,622,801,2771
364959.txt,consult,783,234,622,801,1657
1568369.txt,consult,1870,467,622,801,1890
1545677.txt,consult,2143,551,622,801,1974
529997.txt,consult,3054,672,622,801,2095
1587596.txt,consult,2122,512,622,801,1935
1165489.txt,consult,779,191,622,801,1614
244078.txt,consult,1449,378,622,801,1801
1098029.txt,consult,1746,447,622,801,1870
1156440.txt,consult,3503,867,622,801,2290
1503544.txt,consult,3508,938,622,801,2361
1271901.txt,consult,2959,711,622,801,2134
1058063.txt,consult,1252,273,622,801,1696
830115.txt,consult,2024,491,622,801,1914
571923.txt,consult,2423,590,622,801,2013
1611667.txt,consult,3158,1115,622,801,2538
242907.txt,consult,1580,367,622,801,1790
59900.txt,consult,1450,355,622,801,1778
1489662.txt,consult,1698,411,622,801,1834
1163398.txt,consult,1311,316,622,801,1739
179936.txt,consult,2635,592,622,801,2015
1072739.txt,consult,2370,535,622,801,1958
1050994.txt,consult,1391,303,622,801,1726
1549397.txt,consult,2808,754,622,801,2177
1476181.txt,consult,1246,297,622,801,1720
1205840.txt,consult,2671,601,622,801,2024
1004073.txt,consult,1448,333,622,801,1756
950542.txt,consult,3122,731,622,801,2154
863584.txt,consult,2013,505,622,801,1928
109260.txt,consult,1963,442,622,801,1865
902720.txt,consult,3167,834,622,801,2257
108958.txt,consult,2500,619,622,801,2042
1100595.txt,consult,2512,588,622,801,2011
1448364.txt,consult,2042,513,622,801,1936
1633435.txt,consult,1629,405,622,801,1828
912141.txt,consult,2105,512,622,801,1935
1203807.txt,consult,1854,401,622,801,1824
1622580.txt,consult,1358,338,622,801,1761
1374538.txt,consult,2664,646,622,801,2069
882001.txt,consult,2248,559,622,801,1982
1024961.txt,consult,1908,433,622,801,1856
438752.txt,consult,2245,530,622,801,1953
256537.txt,consult,816,238,622,801,1661
1503846.txt,consult,2314,630,622,801,2053
1142224.txt,consult,1637,367,622,801,1790
437522.txt,consult,1732,432,622,801,1855
822853.txt,consult,2325,540,622,801,1963
1269016.txt,consult,1367,336,622,801,1759
1489909.txt,consult,2959,741,622,801,2164
1295666.txt,consult,2724,664,622,801,2087
1519382.txt,consult,1631,409,622,801,1832
1266899.txt,consult,2010,502,622,801,1925
138482.txt,consult,1939,443,622,801,1866
1178706.txt,consult,1889,454,622,801,1877
1108013.txt,consult,2705,569,622,801,1992
1510013.txt,consult,2421,599,622,801,2022
802950.txt,consult,2582,720,622,801,2143
851872.txt,consult,991,226,622,801,1649
1051911.txt,consult,1633,404,622,801,1827
970236.txt,consult,2989,710,622,801,2133
1486934.txt,consult,1994,493,622,801,1916
1211203.txt,consult,2866,751,622,801,2174
1131412.txt,consult,1623,392,622,801,1815
126518.txt,consult,2049,554,622,801,1977
348061.txt,consult,1432,326,622,801,1749
777248.txt,consult,2438,576,622,801,1999
1249167.txt,consult,3285,716,622,801,2139
900465.txt,consult,3238,832,622,801,2255
1211282.txt,consult,838,208,622,801,1631
1314856.txt,consult,3633,837,622,801,2260
334421.txt,consult,3199,818,622,801,2241
1029972.txt,consult,1715,401,622,801,1824
381326.txt,consult,2256,514,622,801,1937
135560.txt,consult,1776,488,622,801,1911
1130580.txt,consult,2421,588,622,801,2011
1316912.txt,consult,1745,438,622,801,1861
900490.txt,consult,2876,732,622,801,2155
1336918.txt,consult,1874,473,622,801,1896
1157207.txt,consult,3286,808,622,801,2231
436641.txt,consult,4648,1093,622,801,2516
1416427.txt,consult,1797,444,622,801,1867
493821.txt,consult,1657,422,622,801,1845
1189263.txt,consult,2709,612,622,801,2035
739007.txt,consult,2952,728,622,801,2151
97134.txt,consult,1782,468,622,801,1891
125021.txt,consult,3159,763,622,801,2186
1204131.txt,consult,4403,1027,622,801,2450
654327.txt,consult,1793,439,622,801,1862
1524429.txt,consult,2496,641,622,801,2064
376941.txt,consult,3044,801,622,801,2224
1006301.txt,consult,2194,538,622,801,1961
291263.txt,consult,2635,574,622,801,1997
1226239.txt,consult,2373,542,622,801,1965
235316.txt,consult,1928,459,622,801,1882
1076986.txt,consult,2569,625,622,801,2048
804225.txt,consult,3703,894,622,801,2317
1460110.txt,consult,1998,470,622,801,1893
284231.txt,consult,3595,825,622,801,2248
1475415.txt,consult,1569,410,622,801,1833
207046.txt,consult,831,243,622,801,1666
1106419.txt,consult,4364,971,622,801,2394
556923.txt,consult,3047,741,622,801,2164
1186884.txt,consult,2560,575,622,801,1998
1240634.txt,consult,2861,703,622,801,2126
112340.txt,consult,4227,1020,622,801,2443
381460.txt,consult,1661,421,622,801,1844
1237434.txt,consult,2286,526,622,801,1949
160444.txt,consult,1382,332,622,801,1755
1477536.txt,consult,3071,714,622,801,2137
1331038.txt,consult,1055,259,622,801,1682
1033633.txt,consult,788,203,622,801,1626
335339.txt,consult,798,217,622,801,1640
584848.txt,consult,2345,530,622,801,1953
1274025.txt,consult,2414,570,622,801,1993
1354697.txt,consult,1833,435,622,801,1858
1308813.txt,consult,2980,745,622,801,2168
1019973.txt,consult,7727,1797,622,801,3220
704145.txt,consult,3648,943,622,801,2366
1290109.txt,consult,2820,716,622,801,2139
1311697.txt,consult,1585,398,622,801,1821
1378340.txt,consult,2985,744,622,801,2167
667872.txt,consult,4567,1060,622,801,2483
1626507.txt,consult,1916,440,622,801,1863
1294458.txt,consult,3449,876,622,801,2299
345463.txt,consult,2725,617,622,801,2040
1352387.txt,consult,1681,401,622,801,1824
1311615.txt,consult,3931,937,622,801,2360
1181436.txt,consult,3041,730,622,801,2153
1199165.txt,consult,1122,250,622,801,1673
1075533.txt,consult,3532,801,622,801,2224
493824.txt,consult,2820,674,622,801,2097
1457897.txt,consult,2302,571,622,801,1994
188433.txt,consult,3160,770,622,801,2193
920788.txt,consult,2769,669,622,801,2092
1611082.txt,consult,1543,406,622,801,1829
1063104.txt,consult,3157,793,622,801,2216
1066995.txt,consult,2866,741,622,801,2164
454921.txt,consult,2809,710,622,801,2133
460934.txt,consult,1901,443,622,801,1866
1158727.txt,consult,847,188,622,801,1611
1275731.txt,consult,1987,470,622,801,1893
1014012.txt,consult,1639,404,622,801,1827
884999.txt,consult,1575,384,622,801,1807
424609.txt,consult,5066,1163,622,801,2586
1296627.txt,consult,1506,376,622,801,1799
250322.txt,consult,2241,552,622,801,1975
1145024.txt,consult,2521,571,622,801,1994
267658.txt,consult,2068,480,622,801,1903
1472524.txt,consult,2244,599,622,801,2022
1294809.txt,consult,1278,319,622,801,1742
106520.txt,consult,774,208,622,801,1631
575788.txt,consult,3951,1002,622,801,2425
1063150.txt,consult,3648,864,622,801,2287
315566.txt,consult,1255,308,622,801,1731
1208233.txt,consult,2096,492,622,801,1915
988682.txt,consult,3927,956,622,801,2379
147889.txt,consult,1881,445,622,801,1868
1374085.txt,consult,1655,407,622,801,1830
1264635.txt,consult,2038,499,622,801,1922
57971.txt,consult,1613,413,622,801,1836
1469478.txt,consult,2998,756,622,801,2179
1598456.txt,consult,1897,454,622,801,1877
870925.txt,consult,2434,618,622,801,2041
1475978.txt,consult,1274,336,622,801,1759
760243.txt,consult,2156,592,622,801,2015
491733.txt,consult,4046,1072,622,801,2495
767722.txt,consult,3680,847,622,801,2270
579564.txt,consult,1306,311,622,801,1734
1058395.txt,consult,4477,1105,622,801,2528
1212081.txt,consult,1619,393,622,801,1816
1069515.txt,consult,2179,542,622,801,1965
651847.txt,consult,3700,946,622,801,2369
1254031.txt,consult,4190,1038,622,801,2461
639074.txt,consult,2509,558,622,801,1981
820516.txt,consult,4463,1060,622,801,2483
1292894.txt,consult,2456,611,622,801,2034
1045725.txt,consult,2355,585,622,801,2008
1176853.txt,consult,3061,699,622,801,2122
1254757.txt,consult,2888,734,622,801,2157
1009880.txt,consult,2004,478,622,801,1901
1312475.txt,consult,3052,711,622,801,2134
324434.txt,consult,2145,558,622,801,1981
1031266.txt,consult,1949,450,622,801,1873
1262059.txt,consult,2385,608,622,801,2031
1085010.txt,consult,3105,779,622,801,2202
758933.txt,consult,2575,606,622,801,2029
847829.txt,consult,4575,1081,622,801,2504
1215113.txt,consult,1994,454,622,801,1877
1548911.txt,consult,4969,1248,622,801,2671
520978.txt,consult,3245,803,622,801,2226
220399.txt,consult,1997,506,622,801,1929
610810.txt,consult,2780,746,622,801,2169
156086.txt,consult,1858,428,622,801,1851
1261266.txt,consult,2676,726,622,801,2149
129701.txt,consult,2166,515,622,801,1938
1244332.txt,consult,2594,633,622,801,2056
959920.txt,consult,867,237,622,801,1660
1077516.txt,consult,3301,799,622,801,2222
385207.txt,consult,2921,764,622,801,2187
1426731.txt,consult,1565,375,622,801,1798
449018.txt,consult,3439,805,622,801,2228
1366321.txt,consult,1739,407,622,801,1830
1362878.txt,consult,1651,388,622,801,1811
775865.txt,consult,5898,1347,622,801,2770
628178.txt,consult,2104,521,622,801,1944
1473020.txt,consult,2544,638,622,801,2061
458865.txt,consult,1522,375,622,801,1798
1623163.txt,consult,2650,672,622,801,2095
1164759.txt,consult,1933,486,622,801,1909
1444811.txt,consult,2045,505,622,801,1928
759432.txt,consult,1146,284,622,801,1707
771523.txt,consult,1857,438,622,801,1861
816794.txt,consult,1485,526,622,801,1949
726562.txt,consult,2956,726,622,801,2149
1528517.txt,consult,846,279,622,801,1702
1208740.txt,consult,3399,888,622,801,2311
1591388.txt,consult,1426,369,622,801,1792
1021737.txt,consult,3913,902,622,801,2325
488193.txt,consult,1411,322,622,801,1745
1287301.txt,consult,1748,426,622,801,1849
1591620.txt,consult,2145,553,622,801,1976
1028731.txt,consult,2239,532,622,801,1955
1303763.txt,consult,1610,448,622,801,1871
1142707.txt,consult,2559,584,622,801,2007
451971.txt,consult,2527,601,622,801,2024
465567.txt,consult,3189,852,622,801,2275
1060695.txt,consult,2752,624,622,801,2047
1287020.txt,consult,1608,387,622,801,1810
1080438.txt,consult,2302,526,622,801,1949
738759.txt,consult,1735,414,622,801,1837
1254308.txt,consult,1813,429,622,801,1852
731683.txt,consult,1699,410,622,801,1833
990489.txt,consult,1309,337,622,801,1760
13428.txt,consult,2196,507,622,801,1930
1586663.txt,consult,1774,448,622,801,1871
1458541.txt,consult,1697,410,622,801,1833
1309309.txt,consult,2195,570,622,801,1993
451834.txt,consult,3840,960,622,801,2383
1213422.txt,consult,2335,569,622,801,1992
1133805.txt,consult,2484,608,622,801,2031
1164049.txt,consult,1867,446,622,801,1869
1306232.txt,consult,815,211,622,801,1634
1146888.txt,consult,2366,541,622,801,1964
1089362.txt,consult,2550,578,622,801,2001
1332528.txt,consult,1490,370,622,801,1793
395523.txt,consult,1366,323,622,801,1746
1518987.txt,consult,1578,389,622,801,1812
1247386.txt,consult,2458,582,622,801,2005
1319850.txt,consult,1435,367,622,801,1790
6369.txt,consult,1817,481,622,801,1904
551914.txt,consult,4843,1091,622,801,2514
1066410.txt,consult,3131,769,622,801,2192
277917.txt,consult,4339,1055,622,801,2478
441995.txt,consult,2876,676,622,801,2099
761661.txt,consult,2345,549,622,801,1972
519494.txt,consult,4260,968,622,801,2391
1102119.txt,consult,3430,767,622,801,2190
9131.txt,consult,3317,930,622,801,2353
276343.txt,consult,1998,438,622,801,1861
865277.txt,consult,1674,418,622,801,1841
276261.txt,consult,5761,1361,622,801,2784
166906.txt,consult,2812,723,622,801,2146
136458.txt,consult,2393,534,622,801,1957
313323.txt,consult,856,216,622,801,1639
1291361.txt,consult,1674,382,622,801,1805
568216.txt,consult,3286,742,622,801,2165
837503.txt,consult,2720,608,622,801,2031
359825.txt,consult,925,199,622,801,1622
732897.txt,consult,2195,505,622,801,1928
1293535.txt,consult,1691,421,622,801,1844
1118019.txt,consult,2043,486,622,801,1909
745421.txt,consult,2265,555,622,801,1978
1414617.txt,consult,1344,334,622,801,1757
655883.txt,consult,2384,554,622,801,1977
1261144.txt,consult,2631,672,622,801,2095
1460055.txt,consult,1393,356,622,801,1779
111738.txt,consult,2136,489,622,801,1912
1263722.txt,consult,1956,469,622,801,1892
144296.txt,consult,1125,272,622,801,1695
1229797.txt,consult,1480,388,622,801,1811
152023.txt,consult,861,233,622,801,1656
357871.txt,consult,2450,619,622,801,2042
24410.txt,consult,3269,861,622,801,2284
1442530.txt,consult,1336,325,622,801,1748
44651.txt,consult,1836,453,622,801,1876
1277035.txt,consult,2397,610,622,801,2033
1218398.txt,consult,2459,560,622,801,1983
309014.txt,consult,2493,587,622,801,2010
561902.txt,consult,803,221,622,801,1644
1135076.txt,consult,835,219,622,801,1642
1136997.txt,consult,2957,731,622,801,2154
1260134.txt,consult,2769,681,622,801,2104
564344.txt,consult,2279,526,622,801,1949
787603.txt,consult,2523,674,622,801,2097
787338.txt,consult,1249,313,622,801,1736
669146.txt,consult,1806,421,622,801,1844
1501803.txt,consult,1905,463,622,801,1886
1048022.txt,consult,5057,1134,622,801,2557
1462301.txt,consult,1681,441,622,801,1864
1337276.txt,consult,1999,507,622,801,1930
1513334.txt,consult,2784,676,622,801,2099
1607304.txt,consult,1592,389,622,801,1812
833851.txt,consult,3936,925,622,801,2348
1284179.txt,consult,1738,421,622,801,1844
1246520.txt,consult,2819,709,622,801,2132
71944.txt,consult,3122,741,622,801,2164
141143.txt,consult,406,105,622,801,1528
924048.txt,consult,2977,684,622,801,2107
1462472.txt,consult,1751,484,622,801,1907
1068235.txt,consult,2778,661,622,801,2084
286563.txt,consult,2559,590,622,801,2013
1421704.txt,consult,1260,303,622,801,1726
1453377.txt,consult,2482,628,622,801,2051
518791.txt,consult,2208,510,622,801,1933
1264572.txt,consult,2469,594,622,801,2017
454098.txt,consult,1698,416,622,801,1839
1107828.txt,consult,2054,469,622,801,1892
388285.txt,consult,820,212,622,801,1635
1434930.txt,consult,1241,313,622,801,1736
552901.txt,consult,1464,359,622,801,1782
910092.txt,consult,3067,734,622,801,2157
1406291.txt,consult,2061,484,622,801,1907
1050579.txt,consult,2702,635,622,801,2058
1181388.txt,consult,2535,591,622,801,2014
1229304.txt,consult,1934,455,622,801,1878
1188128.txt,consult,2012,510,622,801,1933
1365382.txt,consult,1639,411,622,801,1834
832888.txt,consult,1089,230,622,801,1653
747153.txt,consult,3578,863,622,801,2286
100150.txt,consult,1374,299,622,801,1722
1121050.txt,consult,3902,941,622,801,2364
1579197.txt,consult,1259,310,622,801,1733
245845.txt,consult,2213,583,622,801,2006
347246.txt,consult,1313,322,622,801,1745
808965.txt,consult,1489,367,622,801,1790
1247526.txt,consult,2496,579,622,801,2002
1044448.txt,consult,2384,588,622,801,2011
1332542.txt,consult,3301,838,622,801,2261
1209421.txt,consult,2867,707,622,801,2130
755397.txt,consult,1742,383,622,801,1806
1122244.txt,consult,1908,466,622,801,1889
803211.txt,consult,2892,710,622,801,2133
1302380.txt,consult,2359,580,622,801,2003
1626006.txt,consult,1445,356,622,801,1779
1115749.txt,consult,3600,822,622,801,2245
1442355.txt,consult,1692,415,622,801,1838
72493.txt,consult,1476,396,622,801,1819
1089523.txt,consult,3570,856,622,801,2279
795778.txt,consult,765,177,622,801,1600
849051.txt,consult,2779,655,622,801,2078
580293.txt,consult,2130,510,622,801,1933
1302562.txt,consult,2406,540,622,801,1963
763510.txt,consult,3741,961,622,801,2384
1130120.txt,consult,4987,1188,622,801,2611
467893.txt,consult,3790,897,622,801,2320
1513259.txt,consult,1533,417,622,801,1840
1399697.txt,consult,2183,549,622,801,1972
1317057.txt,consult,1358,345,622,801,1768
1348463.txt,consult,2192,514,622,801,1937
630726.txt,consult,4080,982,622,801,2405
980000.txt,consult,2635,614,622,801,2037
1126450.txt,consult,2594,592,622,801,2015
1012904.txt,consult,2835,665,622,801,2088
1078008.txt,consult,2670,675,622,801,2098
1447975.txt,consult,4598,1098,622,801,2521
1266956.txt,consult,2773,645,622,801,2068
1185576.txt,consult,2178,559,622,801,1982
1525413.txt,consult,1953,497,622,801,1920
1026509.txt,consult,2813,632,622,801,2055
1118257.txt,consult,2022,453,622,801,1876
973526.txt,consult,1677,434,622,801,1857
756810.txt,consult,1531,385,622,801,1808
911530.txt,consult,2555,623,622,801,2046
521138.txt,consult,801,226,622,801,1649
1470637.txt,consult,3445,859,622,801,2282
1173780.txt,consult,1672,420,622,801,1843
1083442.txt,consult,2402,562,622,801,1985
810748.txt,consult,4915,1148,622,801,2571
1231206.txt,consult,2292,549,622,801,1972
1266939.txt,consult,1618,411,622,801,1834
1456142.txt,consult,2117,536,622,801,1959
490657.txt,consult,2303,541,622,801,1964
930297.txt,consult,2624,675,622,801,2098
1081091.txt,consult,3391,806,622,801,2229
1310803.txt,consult,1409,349,622,801,1772
1161166.txt,consult,3429,853,622,801,2276
279242.txt,consult,1720,422,622,801,1845
824381.txt,consult,2759,689,622,801,2112
1406838.txt,consult,1963,508,622,801,1931
345750.txt,consult,3820,917,622,801,2340
1629338.txt,consult,1722,449,622,801,1872
1068761.txt,consult,2478,609,622,801,2032
1076826.txt,consult,2583,630,622,801,2053
1092994.txt,consult,2732,630,622,801,2053
964132.txt,consult,2785,656,622,801,2079
367722.txt,consult,1692,424,622,801,1847
108747.txt,consult,1698,380,622,801,1803
1535811.txt,consult,3526,838,622,801,2261
1593669.txt,consult,2659,687,622,801,2110
1445467.txt,consult,1920,512,622,801,1935
170012.txt,consult,2970,718,622,801,2141
1108787.txt,consult,2893,675,622,801,2098
187518.txt,consult,5070,1199,622,801,2622
1295667.txt,consult,1490,370,622,801,1793
1237652.txt,consult,2624,650,622,801,2073
1364626.txt,consult,2834,697,622,801,2120
1137628.txt,consult,1698,386,622,801,1809
1243481.txt,consult,2352,603,622,801,2026
1192207.txt,consult,2477,593,622,801,2016
56276.txt,consult,4623,1122,622,801,2545
761628.txt,consult,2426,598,622,801,2021
1314678.txt,consult,856,243,622,801,1666
1060096.txt,consult,2537,599,622,801,2022
673688.txt,consult,2139,484,622,801,1907
1237993.txt,consult,1199,311,622,801,1734
1362929.txt,consult,3523,819,622,801,2242
1237981.txt,consult,3617,867,622,801,2290
1323861.txt,consult,2334,571,622,801,1994
711775.txt,consult,2325,547,622,801,1970
935281.txt,consult,2235,524,622,801,1947
1338180.txt,consult,1258,322,622,801,1745
1279649.txt,consult,1455,337,622,801,1760
1226244.txt,consult,1579,395,622,801,1818
120069.txt,consult,3747,847,622,801,2270
857282.txt,consult,3209,801,622,801,2224
1146143.txt,consult,1444,400,622,801,1823
1125637.txt,consult,2813,688,622,801,2111
292261.txt,consult,2196,545,622,801,1968
912580.txt,consult,3145,751,622,801,2174
1161635.txt,consult,2824,695,622,801,2118
1295003.txt,consult,2917,727,622,801,2150
1085691.txt,consult,2842,665,622,801,2088
1181132.txt,consult,2156,510,622,801,1933
319885.txt,consult,2152,571,622,801,1994
1291388.txt,consult,1890,471,622,801,1894
1349074.txt,consult,2983,771,622,801,2194
1289908.txt,consult,1961,470,622,801,1893
460075.txt,consult,1191,296,622,801,1719
1560589.txt,consult,2528,627,622,801,2050
336310.txt,consult,3648,833,622,801,2256
1565302.txt,consult,2712,715,622,801,2138
1299439.txt,consult,2428,581,622,801,2004
1456720.txt,consult,1272,325,622,801,1748
